Feature A (i),Feature B (2i),Feature C (-i),Constant Feature,Random Feature,Outcome
2,4,-2,1,0.24247362502113923,A
6,12,-6,1,0.1392460158950476,A
8,16,-8,1,0.1933215265805791,A
9,18,-9,1,0.007544466657179005,A
10,20,-10,1,0.10650668264631447,A
11,22,-11,1,0.7515795197872444,A
16,32,-16,1,0.7753600788051918,A
21,42,-21,1,0.4838588514183595,A
24,48,-24,1,0.6838770649852858,A
26,52,-26,1,0.7838942992005098,A
28,56,-28,1,0.6904414355737788,A
33,66,-33,1,0.6638274314552961,A
34,68,-34,1,0.40880934313345796,A
39,78,-39,1,0.3246339754110634,A
41,82,-41,1,0.3520119071255592,A
42,84,-42,1,0.46458875452995474,A
47,94,-47,1,0.24473570127726185,A
53,106,-53,1,0.7291666722375828,A
54,108,-54,1,0.21696384965111826,A
56,112,-56,1,0.5596977278242431,A
60,120,-60,1,0.37263984823668284,A
64,128,-64,1,0.7591200581865928,A
69,138,-69,1,0.008820977385411877,A
74,148,-74,1,0.5644970822499585,A
77,154,-77,1,0.4934578727296616,A
78,156,-78,1,0.3614599046562429,A
81,162,-81,1,0.11990380669589273,A
83,166,-83,1,0.9997237899702102,A
84,168,-84,1,0.2325826098826046,A
85,170,-85,1,0.9743050591065532,A
89,178,-89,1,0.24132234876801972,A
91,182,-91,1,0.6820341788982959,A
92,184,-92,1,0.45211638306394175,A
93,186,-93,1,0.8122821956498709,A
97,194,-97,1,0.7636781675012181,A
99,198,-99,1,0.02447484434380176,A
101,202,-101,1,0.6601566326377462,A
103,206,-103,1,0.4780030454022165,A
106,212,-106,1,0.3897500507574856,A
109,218,-109,1,0.5342786407680016,A
112,224,-112,1,0.7588764570083875,A
116,232,-116,1,0.25373267965102353,A
117,234,-117,1,0.17640637362439637,A
120,240,-120,1,0.942650393979624,A
124,248,-124,1,0.10987526509777334,A
129,258,-129,1,0.9021061169862651,A
130,260,-130,1,0.11212059849439959,A
140,280,-140,1,0.4561591932667326,A
143,286,-143,1,0.5684832666712509,A
144,288,-144,1,0.14370998761577425,A
146,292,-146,1,0.7570559563899556,A
147,294,-147,1,0.08272165966061917,A
149,298,-149,1,0.7061039188650592,A
151,302,-151,1,0.7535095040332965,A
152,304,-152,1,0.2688988706140675,A
156,312,-156,1,0.6026319174263882,A
161,322,-161,1,0.4053130581867651,A
162,324,-162,1,0.08723741142258079,A
165,330,-165,1,0.9572441126078967,A
169,338,-169,1,0.8192498600908328,A
170,340,-170,1,0.9661454511371863,A
171,342,-171,1,0.6347693780783183,A
173,346,-173,1,0.5620596368907407,A
176,352,-176,1,0.5771934341451038,A
180,360,-180,1,0.04050702381634652,A
181,362,-181,1,0.6338253095302722,A
183,366,-183,1,0.5929915988747113,A
190,380,-190,1,0.8124589904254534,A
196,392,-196,1,0.7960002964051314,A
212,424,-212,1,0.7491560338322789,A
215,430,-215,1,0.453846335520217,A
217,434,-217,1,0.7480978827474892,A
219,438,-219,1,0.23790447325632624,A
224,448,-224,1,0.198229918221416,A
233,466,-233,1,0.05056993692060008,A
235,470,-235,1,0.6924232041206027,A
238,476,-238,1,0.013132670188667928,A
240,480,-240,1,0.8549767586532494,A
244,488,-244,1,0.6903307191343461,A
249,498,-249,1,0.19866254909013237,A
250,500,-250,1,0.2614214105140611,A
256,512,-256,1,0.015963880166720013,A
261,522,-261,1,0.8627558825388136,A
268,536,-268,1,0.22940824626869794,A
274,548,-274,1,0.9267210664306688,A
279,558,-279,1,0.7353655622199748,A
284,568,-284,1,0.06388603394204195,A
286,572,-286,1,0.7570247152345454,A
287,574,-287,1,0.3679759059314712,A
290,580,-290,1,0.04854210208406273,A
292,584,-292,1,0.912073894219383,A
295,590,-295,1,0.4449321093452897,A
297,594,-297,1,0.38223966078185967,A
299,598,-299,1,0.34329157419696543,A
300,600,-300,1,0.8765832360417507,A
302,604,-302,1,0.5235373693703745,A
307,614,-307,1,0.5655100362776335,A
308,616,-308,1,0.07632899443323804,A
314,628,-314,1,0.00027862495726971304,A
318,636,-318,1,0.7102060389337171,A
319,638,-319,1,0.19140195110601577,A
322,644,-322,1,0.8712562995629993,A
323,646,-323,1,0.8117111883840915,A
324,648,-324,1,0.44915962237974516,A
326,652,-326,1,0.7423485110675877,A
328,656,-328,1,0.9877584949447571,A
329,658,-329,1,0.3133335571111364,A
332,664,-332,1,0.6572190842689922,A
335,670,-335,1,0.8586915954454304,A
336,672,-336,1,0.18203931066818058,A
338,676,-338,1,0.9621446619913385,A
344,688,-344,1,0.5538940202873247,A
345,690,-345,1,0.9618040333336279,A
352,704,-352,1,0.3628382187880891,A
355,710,-355,1,0.5994950367982766,A
356,712,-356,1,0.7421116838356253,A
359,718,-359,1,0.20350529184377897,A
360,720,-360,1,0.9946411088390771,A
363,726,-363,1,0.6160013238368346,A
365,730,-365,1,0.5590432410082322,A
366,732,-366,1,0.2675195954038949,A
367,734,-367,1,0.4259244662128553,A
373,746,-373,1,0.6212120351862683,A
374,748,-374,1,0.9382710843311934,A
378,756,-378,1,0.7573658864346664,A
379,758,-379,1,0.7455265630973177,A
382,764,-382,1,0.8646143677780165,A
385,770,-385,1,0.5368084262891224,A
389,778,-389,1,0.6318101355568811,A
390,780,-390,1,0.9875601206397089,A
393,786,-393,1,0.05792952833867926,A
394,788,-394,1,0.7928609116396774,A
396,792,-396,1,0.5031570740979463,A
397,794,-397,1,0.553019177146149,A
398,796,-398,1,0.723703376193784,A
401,802,-401,1,0.20307726977136853,A
402,804,-402,1,0.09431942401902871,A
403,806,-403,1,0.806062899172243,A
406,812,-406,1,0.9682034304341919,A
407,814,-407,1,0.7087302306382116,A
409,818,-409,1,0.9746196466314233,A
411,822,-411,1,0.7262836522940526,A
416,832,-416,1,0.35298962950231294,A
418,836,-418,1,0.48798626593698957,A
424,848,-424,1,0.17675463236985234,A
427,854,-427,1,0.7268941716735843,A
429,858,-429,1,0.4384679725458762,A
431,862,-431,1,0.4577927512366081,A
434,868,-434,1,0.4160747382383485,A
435,870,-435,1,0.8988231030377717,A
443,886,-443,1,0.42425893765110845,A
447,894,-447,1,0.13367101799176906,A
448,896,-448,1,0.38028911655355835,A
450,900,-450,1,0.736356824276808,A
453,906,-453,1,0.8904239988732695,A
455,910,-455,1,0.8514209153852024,A
460,920,-460,1,0.7125518330075965,A
461,922,-461,1,0.698689197857949,A
463,926,-463,1,0.4335792303103485,A
467,934,-467,1,0.13529243237464061,A
469,938,-469,1,0.21786496123233723,A
471,942,-471,1,0.9923492765758359,A
474,948,-474,1,0.10135444101465696,A
479,958,-479,1,0.9903967672495232,A
481,962,-481,1,0.5106859579056284,A
482,964,-482,1,0.36431393442378135,A
490,980,-490,1,0.42815389397597103,A
492,984,-492,1,0.3314631970430161,A
495,990,-495,1,0.04092658721531117,A
499,998,-499,1,0.2379231389422911,A
500,1000,-500,1,0.19312043701303527,A
501,1002,-501,1,0.8056720804532861,A
511,1022,-511,1,0.2888239618285633,A
513,1026,-513,1,0.7816585780381974,A
517,1034,-517,1,0.693025407420385,A
520,1040,-520,1,0.346999371685474,A
521,1042,-521,1,0.1266702312839948,A
525,1050,-525,1,0.14709922609163295,A
526,1052,-526,1,0.8641637318999918,A
528,1056,-528,1,0.7034437632450338,A
531,1062,-531,1,0.3494064651980876,A
533,1066,-533,1,0.012312714655241974,A
534,1068,-534,1,0.09953092869653835,A
535,1070,-535,1,0.4290922953994375,A
537,1074,-537,1,0.46118000956873273,A
538,1076,-538,1,0.30200053617129496,A
539,1078,-539,1,0.63428033104693,A
540,1080,-540,1,0.6058851479299371,A
541,1082,-541,1,0.6688575134249012,A
544,1088,-544,1,0.9602563275181741,A
545,1090,-545,1,0.9797325529460156,A
549,1098,-549,1,0.7856477842841129,A
551,1102,-551,1,0.7220195004579232,A
555,1110,-555,1,0.9837812498959759,A
560,1120,-560,1,0.8077555768258373,A
565,1130,-565,1,0.061205339846960416,A
566,1132,-566,1,0.9384934625238395,A
567,1134,-567,1,0.8739461893698989,A
568,1136,-568,1,0.5258234426572744,A
572,1144,-572,1,0.5955952473924271,A
574,1148,-574,1,0.9633945692178592,A
579,1158,-579,1,0.7248885542412847,A
580,1160,-580,1,0.7288647424255965,A
588,1176,-588,1,0.9917433734440388,A
591,1182,-591,1,0.6125775574248253,A
600,1200,-600,1,0.7179178449649902,A
601,1202,-601,1,0.7780020940397042,A
602,1204,-602,1,0.6273733469580429,A
604,1208,-604,1,0.16238048165259245,A
610,1220,-610,1,0.5613226297772406,A
611,1222,-611,1,0.676512407154793,A
625,1250,-625,1,0.885760742269449,A
626,1252,-626,1,0.9771972260834293,A
631,1262,-631,1,0.5725925953103703,A
635,1270,-635,1,0.010948527160148047,A
638,1276,-638,1,0.44884177499101563,A
640,1280,-640,1,0.8102236611127712,A
642,1284,-642,1,0.6513413460785029,A
648,1296,-648,1,0.61083631423026,A
653,1306,-653,1,0.16183532196383488,A
654,1308,-654,1,0.711145639261964,A
655,1310,-655,1,0.024341313446575974,A
656,1312,-656,1,0.3119027543631523,A
657,1314,-657,1,0.2018034853475592,A
658,1316,-658,1,0.5685638602887763,A
664,1328,-664,1,0.1324207086151955,A
669,1338,-669,1,0.6543723965989391,A
675,1350,-675,1,0.9366259204272844,A
677,1354,-677,1,0.9745263568516005,A
678,1356,-678,1,0.7522891691780813,A
679,1358,-679,1,0.517617455875347,A
683,1366,-683,1,0.6142577746957558,A
684,1368,-684,1,0.21963651992127742,A
685,1370,-685,1,0.5444221513135497,A
696,1392,-696,1,0.4787042090543606,A
699,1398,-699,1,0.938020636560152,A
702,1404,-702,1,0.754454145949289,A
710,1420,-710,1,0.7866658400713755,A
711,1422,-711,1,0.27908003341318943,A
715,1430,-715,1,0.5766563343414036,A
716,1432,-716,1,0.7382729478565982,A
724,1448,-724,1,0.030860738511360064,A
726,1452,-726,1,0.005890838271095711,A
729,1458,-729,1,0.5657851889415352,A
730,1460,-730,1,0.6009912174057376,A
731,1462,-731,1,0.84268180223102,A
734,1468,-734,1,0.8034394600940702,A
737,1474,-737,1,0.7028405960891304,A
738,1476,-738,1,0.248829623863004,A
739,1478,-739,1,0.11723342473755816,A
740,1480,-740,1,0.8945081410905967,A
741,1482,-741,1,0.7713559819415783,A
745,1490,-745,1,0.6023828167056002,A
746,1492,-746,1,0.001867784896013136,A
750,1500,-750,1,0.700492172073896,A
753,1506,-753,1,0.4890559743034706,A
757,1514,-757,1,0.5783992545881244,A
763,1526,-763,1,0.27976739772535875,A
765,1530,-765,1,0.5879643699328965,A
770,1540,-770,1,0.9808811045711272,A
772,1544,-772,1,0.2240924970669077,A
774,1548,-774,1,0.49745702561319716,A
775,1550,-775,1,0.6536709061764728,A
779,1558,-779,1,0.7289764585599885,A
780,1560,-780,1,0.20169929329925385,A
783,1566,-783,1,0.041938324556092255,A
790,1580,-790,1,0.6540012593329242,A
791,1582,-791,1,0.21671367944846542,A
792,1584,-792,1,0.8283930356645302,A
805,1610,-805,1,0.09854691903294122,A
806,1612,-806,1,0.7263686228210692,A
808,1616,-808,1,0.7736377711289548,A
814,1628,-814,1,0.7665001377339188,A
816,1632,-816,1,0.5267345413009766,A
821,1642,-821,1,0.8955447679423133,A
822,1644,-822,1,0.7736404823153804,A
824,1648,-824,1,0.0675435465639479,A
827,1654,-827,1,0.43148082094678075,A
828,1656,-828,1,0.5379284507166919,A
831,1662,-831,1,0.2512417524775168,A
836,1672,-836,1,0.2601338565708431,A
837,1674,-837,1,0.9726903649181334,A
846,1692,-846,1,0.6568051235689084,A
847,1694,-847,1,0.6732773943894848,A
851,1702,-851,1,0.2977139387284573,A
858,1716,-858,1,0.4837712300813497,A
859,1718,-859,1,0.048055444360501576,A
860,1720,-860,1,0.05408012453648248,A
862,1724,-862,1,0.4562626898739802,A
871,1742,-871,1,0.06664133113867887,A
873,1746,-873,1,0.12199862667717054,A
875,1750,-875,1,0.8894507457925992,A
878,1756,-878,1,0.23131532280880063,A
881,1762,-881,1,0.6642895016465611,A
885,1770,-885,1,0.33920013645784863,A
887,1774,-887,1,0.8052982547677229,A
889,1778,-889,1,0.7510357614242231,A
890,1780,-890,1,0.7834747753305632,A
892,1784,-892,1,0.07334193449399606,A
898,1796,-898,1,0.03153784850576358,A
900,1800,-900,1,0.6025110366060283,A
902,1804,-902,1,0.7333453518253276,A
906,1812,-906,1,0.5256565641783999,A
910,1820,-910,1,0.9440698949225251,A
913,1826,-913,1,0.18837156173677239,A
921,1842,-921,1,0.07593153395458951,A
922,1844,-922,1,0.19944683911294736,A
923,1846,-923,1,0.6250247582341064,A
927,1854,-927,1,0.5132371494038765,A
931,1862,-931,1,0.5237383229828718,A
932,1864,-932,1,0.7793208287389438,A
933,1866,-933,1,0.6263308489379642,A
935,1870,-935,1,0.00583346151491082,A
937,1874,-937,1,0.1128404191180622,A
938,1876,-938,1,0.8509833757548774,A
940,1880,-940,1,0.08065928323066784,A
945,1890,-945,1,0.8224797298511567,A
946,1892,-946,1,0.30394758829019397,A
951,1902,-951,1,0.7524281545624589,A
952,1904,-952,1,0.6614184641688952,A
954,1908,-954,1,0.3600462073610273,A
956,1912,-956,1,0.07651884929874087,A
963,1926,-963,1,0.06447657377276017,A
968,1936,-968,1,0.4517420735064158,A
969,1938,-969,1,0.5404761720116715,A
972,1944,-972,1,0.8585005749266947,A
973,1946,-973,1,0.04180368412885771,A
974,1948,-974,1,0.0564080598640766,A
981,1962,-981,1,0.6141309805174597,A
985,1970,-985,1,0.12386079838503472,A
986,1972,-986,1,0.9797194921868494,A
988,1976,-988,1,0.2608750176648411,A
989,1978,-989,1,0.2946203299350447,A
992,1984,-992,1,0.42285564519747254,A
997,1994,-997,1,0.6134559347870694,A
1003,2006,-1003,1,0.9612869480863463,A
1004,2008,-1004,1,0.39181005789646206,A
1007,2014,-1007,1,0.6946411165202077,A
1009,2018,-1009,1,0.05072046478808756,A
1011,2022,-1011,1,0.04039869707173771,A
1013,2026,-1013,1,0.21506748253956587,A
1016,2032,-1016,1,0.4819463726315085,A
1017,2034,-1017,1,0.39663240815737477,A
1018,2036,-1018,1,0.4140463468783748,A
1023,2046,-1023,1,0.5687128958945701,A
1024,2048,-1024,1,0.5377862705037946,A
1025,2050,-1025,1,0.4091177693238597,A
1028,2056,-1028,1,0.8967013900135672,A
1030,2060,-1030,1,0.11012930135611854,A
1035,2070,-1035,1,0.8502803394731202,A
1044,2088,-1044,1,0.40338384994272825,A
1045,2090,-1045,1,0.05193266748694081,A
1046,2092,-1046,1,0.9701763252452951,A
1049,2098,-1049,1,0.29890695525086286,A
1056,2112,-1056,1,0.36171221179810853,A
1058,2116,-1058,1,0.16143279050583048,A
1060,2120,-1060,1,0.1304354892282128,A
1061,2122,-1061,1,0.014220419503267023,A
1064,2128,-1064,1,0.5610486066810418,A
1067,2134,-1067,1,0.08739073229227945,A
1068,2136,-1068,1,0.4387830518235647,A
1070,2140,-1070,1,0.12421895935944949,A
1073,2146,-1073,1,0.27453532900199173,A
1081,2162,-1081,1,0.32312580119664536,A
1083,2166,-1083,1,0.7891761898929606,A
1084,2168,-1084,1,0.9440419635282654,A
1086,2172,-1086,1,0.20996563407162938,A
1088,2176,-1088,1,0.952165445746176,A
1090,2180,-1090,1,0.4848444429826487,A
1092,2184,-1092,1,0.7976726650045156,A
1095,2190,-1095,1,0.8396743900219306,A
1106,2212,-1106,1,0.35246220314550525,A
1108,2216,-1108,1,0.4873748724607506,A
1109,2218,-1109,1,0.07093121864185747,A
1110,2220,-1110,1,0.147480574146166,A
1114,2228,-1114,1,0.5324218237148725,A
1116,2232,-1116,1,0.43572084052485127,A
1118,2236,-1118,1,0.9470619666866824,A
1119,2238,-1119,1,0.760189095003514,A
1121,2242,-1121,1,0.5294288601117195,A
1122,2244,-1122,1,0.8502578644462622,A
1123,2246,-1123,1,0.4690401831406058,A
1128,2256,-1128,1,0.03218998505713,A
1129,2258,-1129,1,0.9544652736399171,A
1132,2264,-1132,1,0.12768470245932062,A
1134,2268,-1134,1,0.6192059650368904,A
1136,2272,-1136,1,0.10303793265332128,A
1143,2286,-1143,1,0.6882972966374383,A
1145,2290,-1145,1,0.7526029817826788,A
1147,2294,-1147,1,0.538292574414094,A
1156,2312,-1156,1,0.5454662075945753,A
1159,2318,-1159,1,0.7257043537013906,A
1160,2320,-1160,1,0.52399149864106,A
1165,2330,-1165,1,0.6524176469367197,A
1170,2340,-1170,1,0.010076571393086486,A
1171,2342,-1171,1,0.3287378651158941,A
1180,2360,-1180,1,0.6864472138287108,A
1182,2364,-1182,1,0.6847950348031145,A
1183,2366,-1183,1,0.7747891457173256,A
1189,2378,-1189,1,0.4752107464197891,A
1190,2380,-1190,1,0.14766948169078142,A
1191,2382,-1191,1,0.7169357497315684,A
1193,2386,-1193,1,0.42051747445980125,A
1195,2390,-1195,1,0.318015201257416,A
1196,2392,-1196,1,0.10123870460775819,A
1197,2394,-1197,1,0.27928490918995175,A
1199,2398,-1199,1,0.34121033838894277,A
1202,2404,-1202,1,0.37442403492859644,A
1203,2406,-1203,1,0.7395516512909632,A
1205,2410,-1205,1,0.6461704656366158,A
1212,2424,-1212,1,0.4782809530228377,A
1221,2442,-1221,1,0.27560046925746784,A
1222,2444,-1222,1,0.7453425351433025,A
1224,2448,-1224,1,0.47764223297795627,A
1225,2450,-1225,1,0.4817253222268343,A
1226,2452,-1226,1,0.018075805844576798,A
1229,2458,-1229,1,0.61491194329507,A
1238,2476,-1238,1,0.7340436351544045,A
1245,2490,-1245,1,0.160310033644686,A
1246,2492,-1246,1,0.030816609991473398,A
1248,2496,-1248,1,0.06814471803407063,A
1252,2504,-1252,1,0.8057155714021643,A
1253,2506,-1253,1,0.5804494115044786,A
1254,2508,-1254,1,0.8122001567046618,A
1260,2520,-1260,1,0.5262282917432146,A
1263,2526,-1263,1,0.1867015470088519,A
1264,2528,-1264,1,0.9234618050335313,A
1266,2532,-1266,1,0.8010951891827445,A
1267,2534,-1267,1,0.36732529113764933,A
1273,2546,-1273,1,0.07154986597409241,A
1275,2550,-1275,1,0.9033057630747982,A
1277,2554,-1277,1,0.17909027863659854,A
1279,2558,-1279,1,0.1381877449421971,A
1281,2562,-1281,1,0.5852751257474896,A
1282,2564,-1282,1,0.5416631016948618,A
1284,2568,-1284,1,0.8390761771363816,A
1286,2572,-1286,1,0.6011911333027125,A
1287,2574,-1287,1,0.9848977592375109,A
1288,2576,-1288,1,0.6987477009672216,A
1290,2580,-1290,1,0.9553493871790498,A
1302,2604,-1302,1,0.6670838924791862,A
1308,2616,-1308,1,0.799880339207372,A
1313,2626,-1313,1,0.05243212145086118,A
1320,2640,-1320,1,0.2955634628181186,A
1322,2644,-1322,1,0.013242272597950078,A
1326,2652,-1326,1,0.9260846717785076,A
1329,2658,-1329,1,0.21736460719097006,A
1332,2664,-1332,1,0.9110493643014806,A
1336,2672,-1336,1,0.8154396123153943,A
1338,2676,-1338,1,0.5575772393751883,A
1340,2680,-1340,1,0.6500627905050923,A
1343,2686,-1343,1,0.1508313280410859,A
1347,2694,-1347,1,0.11210053747644189,A
1349,2698,-1349,1,0.045028998637681616,A
1350,2700,-1350,1,0.8655135035485882,A
1351,2702,-1351,1,0.11315997009979184,A
1353,2706,-1353,1,0.576939140448861,A
1354,2708,-1354,1,0.38691522873368267,A
1356,2712,-1356,1,0.6145389397472867,A
1357,2714,-1357,1,0.7099923526424639,A
1360,2720,-1360,1,0.8133934559430442,A
1361,2722,-1361,1,0.11947072979649975,A
1363,2726,-1363,1,0.19637139469552023,A
1364,2728,-1364,1,0.8215581587234881,A
1366,2732,-1366,1,0.2498019781154519,A
1370,2740,-1370,1,0.3315712375447968,A
1372,2744,-1372,1,0.8831221136270178,A
1380,2760,-1380,1,0.20697504135837697,A
1381,2762,-1381,1,0.5524245162583513,A
1383,2766,-1383,1,0.1529875010042162,A
1384,2768,-1384,1,0.45907411586592006,A
1389,2778,-1389,1,0.13138984923755936,A
1395,2790,-1395,1,0.3665249179466137,A
1400,2800,-1400,1,0.7533851950979511,A
1402,2804,-1402,1,0.25922400168422477,A
1403,2806,-1403,1,0.397111443931891,A
1404,2808,-1404,1,0.5899784304348034,A
1405,2810,-1405,1,0.19256487006994694,A
1409,2818,-1409,1,0.7393890952582376,A
1417,2834,-1417,1,0.9766555265726391,A
1422,2844,-1422,1,0.16559024868281935,A
1423,2846,-1423,1,0.2607550989639562,A
1424,2848,-1424,1,0.5898680978074963,A
1425,2850,-1425,1,0.7195082409806479,A
1429,2858,-1429,1,0.5233532956688578,A
1430,2860,-1430,1,0.05143173370411158,A
1431,2862,-1431,1,0.22229529860955655,A
1437,2874,-1437,1,0.8460077216809325,A
1441,2882,-1441,1,0.557438564507262,A
1444,2888,-1444,1,0.16701313392350237,A
1450,2900,-1450,1,0.8430614593982131,A
1452,2904,-1452,1,0.7602535957390675,A
1457,2914,-1457,1,0.5841521677235335,A
1458,2916,-1458,1,0.5937771338474276,A
1459,2918,-1459,1,0.9121934453851545,A
1461,2922,-1461,1,0.7098463479510764,A
1462,2924,-1462,1,0.23823551753160166,A
1463,2926,-1463,1,0.09566809499860418,A
1469,2938,-1469,1,0.6987968491910068,A
1475,2950,-1475,1,0.24636406585077097,A
1476,2952,-1476,1,0.8715002014837447,A
1480,2960,-1480,1,0.4444249479503346,A
1487,2974,-1487,1,0.6949158772224937,A
1490,2980,-1490,1,0.8255868776729502,A
1491,2982,-1491,1,0.3548614799436475,A
1497,2994,-1497,1,0.3153149467163112,A
1498,2996,-1498,1,0.8153562672231413,A
1500,3000,-1500,1,0.618667518940082,A
1508,3016,-1508,1,0.045940549982122714,A
1511,3022,-1511,1,0.6439148072861424,A
1514,3028,-1514,1,0.8618530654437658,A
1518,3036,-1518,1,0.9379562724132819,A
1522,3044,-1522,1,0.11308291866275266,A
1526,3052,-1526,1,0.6105469558265261,A
1529,3058,-1529,1,0.9752024262776607,A
1531,3062,-1531,1,0.7142071121603557,A
1544,3088,-1544,1,0.6596945757479795,A
1545,3090,-1545,1,0.23259948564691912,A
1549,3098,-1549,1,0.8071365175699589,A
1551,3102,-1551,1,0.9471191872491157,A
1552,3104,-1552,1,0.05178625893326927,A
1553,3106,-1553,1,0.561973507989752,A
1558,3116,-1558,1,0.46318729413242776,A
1561,3122,-1561,1,0.770389233277831,A
1564,3128,-1564,1,0.7270757068672797,A
1567,3134,-1567,1,0.6787396020637226,A
1568,3136,-1568,1,0.883348615868792,A
1574,3148,-1574,1,0.21997873865630457,A
1575,3150,-1575,1,0.3646107216522597,A
1579,3158,-1579,1,0.7408916499082828,A
1580,3160,-1580,1,0.0954238157925218,A
1581,3162,-1581,1,0.49680763591447963,A
1582,3164,-1582,1,0.4267665787209848,A
1586,3172,-1586,1,0.26382726188674255,A
1587,3174,-1587,1,0.4857019816550242,A
1592,3184,-1592,1,0.18483156203103934,A
1598,3196,-1598,1,0.7589149969559936,A
1606,3212,-1606,1,0.7102797252605016,A
1607,3214,-1607,1,0.42409643246743756,A
1608,3216,-1608,1,0.8196474078411489,A
1611,3222,-1611,1,0.15806757640956903,A
1616,3232,-1616,1,0.34677568516240476,A
1624,3248,-1624,1,0.5511535215260324,A
1625,3250,-1625,1,0.9937064466863195,A
1628,3256,-1628,1,0.546388346480055,A
1629,3258,-1629,1,0.81495954867492,A
1635,3270,-1635,1,0.8161426327921085,A
1639,3278,-1639,1,0.23652458099035012,A
1641,3282,-1641,1,0.5545320555369042,A
1642,3284,-1642,1,0.8972905026743837,A
1643,3286,-1643,1,0.2372151893736728,A
1646,3292,-1646,1,0.5116944754948811,A
1650,3300,-1650,1,0.08911865173623645,A
1653,3306,-1653,1,0.217952609740927,A
1657,3314,-1657,1,0.3897075465948684,A
1660,3320,-1660,1,0.6981201776313987,A
1662,3324,-1662,1,0.6562745021761356,A
1663,3326,-1663,1,0.9457475437810364,A
1664,3328,-1664,1,0.8425284077575813,A
1669,3338,-1669,1,0.09349608443178237,A
1672,3344,-1672,1,0.5073260427161743,A
1682,3364,-1682,1,0.7445612242391493,A
1683,3366,-1683,1,0.48012378748228746,A
1688,3376,-1688,1,0.9448225047037215,A
1689,3378,-1689,1,0.9444195888751451,A
1690,3380,-1690,1,0.4769345426669761,A
1691,3382,-1691,1,0.7603494590043534,A
1693,3386,-1693,1,0.9277840053478077,A
1700,3400,-1700,1,0.7097716483486826,A
1706,3412,-1706,1,0.7624170020320808,A
1711,3422,-1711,1,0.1299219119134989,A
1714,3428,-1714,1,0.4937397456777197,A
1716,3432,-1716,1,0.3914244669292969,A
1718,3436,-1718,1,0.43767642709696486,A
1722,3444,-1722,1,0.7435750561871202,A
1734,3468,-1734,1,0.7404877945582761,A
1735,3470,-1735,1,0.26056083006082564,A
1736,3472,-1736,1,0.4665237662225542,A
1744,3488,-1744,1,0.628081816088871,A
1746,3492,-1746,1,0.9528460437846002,A
1747,3494,-1747,1,0.43508031317412044,A
1748,3496,-1748,1,0.35144398823702394,A
1755,3510,-1755,1,0.5085388314541976,A
1758,3516,-1758,1,0.32858103086140544,A
1760,3520,-1760,1,0.42749414927829954,A
1763,3526,-1763,1,0.8209362203701018,A
1768,3536,-1768,1,0.7940221851054722,A
1774,3548,-1774,1,0.6817763962540677,A
1779,3558,-1779,1,0.7753767340594371,A
1786,3572,-1786,1,0.9314865392511156,A
1787,3574,-1787,1,0.470922856177151,A
1788,3576,-1788,1,0.9851614517936872,A
1790,3580,-1790,1,0.649676475868614,A
1792,3584,-1792,1,0.2767533411637434,A
1794,3588,-1794,1,0.052452335121128346,A
1796,3592,-1796,1,0.7693994989488185,A
1798,3596,-1798,1,0.3380150522481128,A
1799,3598,-1799,1,0.22021244933715511,A
1800,3600,-1800,1,0.044496199605657094,A
1803,3606,-1803,1,0.5906395133888752,A
1808,3616,-1808,1,0.6525366787164044,A
1809,3618,-1809,1,0.280879439699124,A
1810,3620,-1810,1,0.8878279127839587,A
1813,3626,-1813,1,0.248685543320609,A
1814,3628,-1814,1,0.7452791266249036,A
1818,3636,-1818,1,0.28600329891235665,A
1820,3640,-1820,1,0.5983150440096549,A
1825,3650,-1825,1,0.24601660718672813,A
1827,3654,-1827,1,0.24594439662408096,A
1830,3660,-1830,1,0.3056065335535759,A
1835,3670,-1835,1,0.19441894857946906,A
1838,3676,-1838,1,0.26611445697599667,A
1840,3680,-1840,1,0.10182387552677441,A
1844,3688,-1844,1,0.16956444132607873,A
1847,3694,-1847,1,0.5206886174939613,A
1852,3704,-1852,1,0.8137548236562553,A
1854,3708,-1854,1,0.5132508361972569,A
1859,3718,-1859,1,0.5774041821544653,A
1861,3722,-1861,1,0.3169057762516906,A
1864,3728,-1864,1,0.609421840940453,A
1866,3732,-1866,1,0.6030546596513986,A
1867,3734,-1867,1,0.2632909136886715,A
1868,3736,-1868,1,0.5116895670850874,A
1872,3744,-1872,1,0.7135118462225554,A
1874,3748,-1874,1,0.06044638326609053,A
1883,3766,-1883,1,0.8304602330071875,A
1884,3768,-1884,1,0.2120758542955583,A
1885,3770,-1885,1,0.12404886721292863,A
1888,3776,-1888,1,0.10694320165086335,A
1899,3798,-1899,1,0.6339533078769813,A
1900,3800,-1900,1,0.6616332425340274,A
1907,3814,-1907,1,0.5620099594945723,A
1912,3824,-1912,1,0.6923151103638552,A
1914,3828,-1914,1,0.33159333181888806,A
1916,3832,-1916,1,0.5306751214989337,A
1918,3836,-1918,1,0.500620960806754,A
1920,3840,-1920,1,0.30201024689413203,A
1923,3846,-1923,1,0.879990648466736,A
1925,3850,-1925,1,0.18512441420059167,A
1926,3852,-1926,1,0.4188517254448926,A
1930,3860,-1930,1,0.5261946868408973,A
1932,3864,-1932,1,0.5008473171116676,A
1934,3868,-1934,1,0.23404940348930714,A
1936,3872,-1936,1,0.08148806941284847,A
1945,3890,-1945,1,0.754910438819911,A
1946,3892,-1946,1,0.9264659426402666,A
1950,3900,-1950,1,0.40871669976633207,A
1952,3904,-1952,1,0.7820264660066238,A
1959,3918,-1959,1,0.37807390414543474,A
1960,3920,-1960,1,0.2575082307142412,A
1966,3932,-1966,1,0.1221086079707645,A
1968,3936,-1968,1,0.08623444089501109,A
1969,3938,-1969,1,0.5371745211300358,A
1970,3940,-1970,1,0.5093891518159599,A
1971,3942,-1971,1,0.6299172986202274,A
1972,3944,-1972,1,0.8803470048502919,A
1976,3952,-1976,1,0.4031443527487162,A
1980,3960,-1980,1,0.09184243189170604,A
1981,3962,-1981,1,0.5336816844283848,A
1984,3968,-1984,1,0.1108468433334322,A
1988,3976,-1988,1,0.016058670742490677,A
1991,3982,-1991,1,0.6035749651070378,A
1996,3992,-1996,1,0.028966690078865542,A
2005,4010,-2005,1,0.3884562660569221,A
2006,4012,-2006,1,0.907224510472837,A
2011,4022,-2011,1,0.015003111230696864,A
2024,4048,-2024,1,0.05189116368125146,A
2025,4050,-2025,1,0.006440470514348484,A
2028,4056,-2028,1,0.032225653970787915,A
2032,4064,-2032,1,0.48081130339983613,A
2037,4074,-2037,1,0.2051449321147304,A
2041,4082,-2041,1,0.36889771871665467,A
2047,4094,-2047,1,0.5784278078720546,A
2049,4098,-2049,1,0.0015036394146941134,A
2052,4104,-2052,1,0.8690272516626282,A
2057,4114,-2057,1,0.7209084999472862,A
2058,4116,-2058,1,0.5621796340309206,A
2060,4120,-2060,1,0.6699381031553489,A
2061,4122,-2061,1,0.45887200475353507,A
2062,4124,-2062,1,0.027504248753600247,A
2064,4128,-2064,1,0.3546977685207361,A
2075,4150,-2075,1,0.7835986208609758,A
2079,4158,-2079,1,0.6970480776480305,A
2080,4160,-2080,1,0.6032581268524336,A
2083,4166,-2083,1,0.3938176795203506,A
2088,4176,-2088,1,0.9627180236439512,A
2090,4180,-2090,1,0.002651466156328941,A
2092,4184,-2092,1,0.9261417447017305,A
2093,4186,-2093,1,0.20408480860425415,A
2094,4188,-2094,1,0.9994466062899926,A
2096,4192,-2096,1,0.3832045756036392,A
2099,4198,-2099,1,0.497325473262647,A
2104,4208,-2104,1,0.6539062435791179,A
2107,4214,-2107,1,0.9322089581557026,A
2108,4216,-2108,1,0.10169486551450779,A
2113,4226,-2113,1,0.320866444869506,A
2116,4232,-2116,1,0.2685167287800295,A
2118,4236,-2118,1,0.5351831863481279,A
2121,4242,-2121,1,0.708809724867279,A
2122,4244,-2122,1,0.22401682834527614,A
2125,4250,-2125,1,0.9344911017708522,A
2126,4252,-2126,1,0.7220068127065495,A
2130,4260,-2130,1,0.5842152348490041,A
2131,4262,-2131,1,0.3406401937237402,A
2133,4266,-2133,1,0.11150812821728273,A
2135,4270,-2135,1,0.6934578472974756,A
2141,4282,-2141,1,0.8255362885668756,A
2143,4286,-2143,1,0.6910341155125276,A
2145,4290,-2145,1,0.5011626493750025,A
2153,4306,-2153,1,0.3104382626740937,A
2162,4324,-2162,1,0.547595834157556,A
2164,4328,-2164,1,0.3790443674723275,A
2165,4330,-2165,1,0.4825441258206383,A
2166,4332,-2166,1,0.15740053430701584,A
2168,4336,-2168,1,0.5193430189424365,A
2169,4338,-2169,1,0.013695839874704907,A
2171,4342,-2171,1,0.14973091406475014,A
2173,4346,-2173,1,0.294783072117102,A
2178,4356,-2178,1,0.5498733121733445,A
2179,4358,-2179,1,0.5852879968291029,A
2180,4360,-2180,1,0.4377173389079758,A
2184,4368,-2184,1,0.5079375858080762,A
2187,4374,-2187,1,0.8377238650575286,A
2196,4392,-2196,1,0.22304672470869413,A
2198,4396,-2198,1,0.25106758872955526,A
2201,4402,-2201,1,0.5637911556689384,A
2208,4416,-2208,1,0.711186965251655,A
2214,4428,-2214,1,0.6375556899100664,A
2216,4432,-2216,1,0.6409979261349328,A
2222,4444,-2222,1,0.8887465221376314,A
2229,4458,-2229,1,0.5841342417168421,A
2230,4460,-2230,1,0.45972780931076196,A
2231,4462,-2231,1,0.7603063903007226,A
2232,4464,-2232,1,0.9799111197028142,A
2235,4470,-2235,1,0.024506152984304697,A
2237,4474,-2237,1,0.5791016402390093,A
2238,4476,-2238,1,0.13244957345355435,A
2242,4484,-2242,1,0.28128097093546445,A
2243,4486,-2243,1,0.6344081188098528,A
2244,4488,-2244,1,0.7678757946091914,A
2257,4514,-2257,1,0.210179310970789,A
2259,4518,-2259,1,0.5335366438879766,A
2266,4532,-2266,1,0.369852142234514,A
2269,4538,-2269,1,0.32578196631385914,A
2271,4542,-2271,1,0.5159684127547977,A
2277,4554,-2277,1,0.14983597622462852,A
2278,4556,-2278,1,0.32719984274697134,A
2286,4572,-2286,1,0.5953184278788957,A
2289,4578,-2289,1,0.6297330448878622,A
2291,4582,-2291,1,0.6803113917495304,A
2299,4598,-2299,1,0.02608501879377012,A
2301,4602,-2301,1,0.27614880696110666,A
2314,4628,-2314,1,0.7942052171894767,A
2315,4630,-2315,1,0.6077237530386381,A
2316,4632,-2316,1,0.9474255117877876,A
2328,4656,-2328,1,0.675197003919644,A
2329,4658,-2329,1,0.5069609290630551,A
2331,4662,-2331,1,0.12920957735664995,A
2333,4666,-2333,1,0.5752014793879149,A
2334,4668,-2334,1,0.11177385827525099,A
2335,4670,-2335,1,0.7280941401709701,A
2336,4672,-2336,1,0.9517607164492133,A
2337,4674,-2337,1,0.2262820777546638,A
2338,4676,-2338,1,0.6913080011508783,A
2341,4682,-2341,1,0.2005186156669272,A
2343,4686,-2343,1,0.20483902906085827,A
2344,4688,-2344,1,0.14929220133849197,A
2345,4690,-2345,1,0.546752748540134,A
2351,4702,-2351,1,0.5778098504573668,A
2353,4706,-2353,1,0.8570005555022825,A
2359,4718,-2359,1,0.8157738398670351,A
2362,4724,-2362,1,0.72220896716802,A
2363,4726,-2363,1,0.30636005295685553,A
2368,4736,-2368,1,0.9186430947706478,A
2370,4740,-2370,1,0.6283385733111161,A
2371,4742,-2371,1,0.8609776491028707,A
2373,4746,-2373,1,0.8669420137366802,A
2377,4754,-2377,1,0.08003878144487186,A
2378,4756,-2378,1,0.8617723317231858,A
2381,4762,-2381,1,0.37424913426737916,A
2384,4768,-2384,1,0.8360658531922777,A
2385,4770,-2385,1,0.31588848067560915,A
2387,4774,-2387,1,0.5632154447013458,A
2388,4776,-2388,1,0.14150291315231034,A
2391,4782,-2391,1,0.939593426307477,A
2394,4788,-2394,1,0.1559742724145896,A
2395,4790,-2395,1,0.7306203562201451,A
2400,4800,-2400,1,0.41258641870195445,A
2401,4802,-2401,1,0.5813759063670417,A
2402,4804,-2402,1,0.5472401726613156,A
2403,4806,-2403,1,0.5937102700034215,A
2404,4808,-2404,1,0.6565337865171418,A
2413,4826,-2413,1,0.5288976941034575,A
2416,4832,-2416,1,0.7828946535636009,A
2421,4842,-2421,1,0.2459445755077907,A
2423,4846,-2423,1,0.6300717803517265,A
2425,4850,-2425,1,0.40603620937462326,A
2428,4856,-2428,1,0.07606287960349056,A
2431,4862,-2431,1,0.26931220881184803,A
2432,4864,-2432,1,0.4672993214129807,A
2434,4868,-2434,1,0.8602328398185817,A
2436,4872,-2436,1,0.23127145920170655,A
2440,4880,-2440,1,0.2783800281435992,A
2441,4882,-2441,1,0.9107052727000392,A
2444,4888,-2444,1,0.6237998093374922,A
2447,4894,-2447,1,0.7869640617486738,A
2448,4896,-2448,1,0.36208227287678263,A
2449,4898,-2449,1,0.25440218995108854,A
2453,4906,-2453,1,0.1713194252785767,A
2455,4910,-2455,1,0.8573453218183783,A
2456,4912,-2456,1,0.4933774553865655,A
2457,4914,-2457,1,0.15239815920445166,A
2460,4920,-2460,1,0.4120040174962366,A
2466,4932,-2466,1,0.7251183719299925,A
2471,4942,-2471,1,0.7908508928624908,A
2475,4950,-2475,1,0.3480719859706318,A
2477,4954,-2477,1,0.8845642718833757,A
2479,4958,-2479,1,0.8979242415269795,A
2482,4964,-2482,1,0.8414004961452196,A
2483,4966,-2483,1,0.509907039403471,A
2484,4968,-2484,1,0.4034788890006783,A
2487,4974,-2487,1,0.6014338006881902,A
2488,4976,-2488,1,0.7054758209253716,A
2492,4984,-2492,1,0.686637531207475,A
2494,4988,-2494,1,0.3739900918905825,A
2496,4992,-2496,1,0.8003859428063077,A
2498,4996,-2498,1,0.02645256868289969,A
2499,4998,-2499,1,0.7694367175252042,A
2511,5022,-2511,1,0.5917649337939991,A
2514,5028,-2514,1,0.10701926293524,A
2515,5030,-2515,1,0.07361843570782012,A
2516,5032,-2516,1,0.7370602373127597,A
2517,5034,-2517,1,0.2083828882066806,A
2518,5036,-2518,1,0.46837871930725317,A
2519,5038,-2519,1,0.23746283171718174,A
2521,5042,-2521,1,0.7934072483187179,A
2524,5048,-2524,1,0.49315234785054585,A
2527,5054,-2527,1,0.3166017741879552,A
2528,5056,-2528,1,0.15494129314425364,A
2529,5058,-2529,1,0.9949093789632122,A
2530,5060,-2530,1,0.563842193204969,A
2532,5064,-2532,1,0.09759854732630835,A
2536,5072,-2536,1,0.6521241915838434,A
2538,5076,-2538,1,0.24749469563287396,A
2546,5092,-2546,1,0.7219306089940876,A
2549,5098,-2549,1,0.7661230054005934,A
2552,5104,-2552,1,0.009353774316349872,A
2553,5106,-2553,1,0.32053269317560906,A
2554,5108,-2554,1,0.044073907995238804,A
2557,5114,-2557,1,0.8178402297878492,A
2558,5116,-2558,1,0.7199979036595002,A
2566,5132,-2566,1,0.04918231375012527,A
2568,5136,-2568,1,0.9167387065592504,A
2571,5142,-2571,1,0.5517957457886751,A
2572,5144,-2572,1,0.9509478972243232,A
2575,5150,-2575,1,0.8765488107756949,A
2577,5154,-2577,1,0.16507690824642063,A
2582,5164,-2582,1,0.5544556241510192,A
2585,5170,-2585,1,0.7408374407729235,A
2588,5176,-2588,1,0.7854197972793132,A
2590,5180,-2590,1,0.30169230676291114,A
2593,5186,-2593,1,0.2097508669648851,A
2594,5188,-2594,1,0.12166547607715716,A
2595,5190,-2595,1,0.020524909903242183,A
2596,5192,-2596,1,0.08654930837501074,A
2598,5196,-2598,1,0.6471364151609852,A
2602,5204,-2602,1,0.26147632846813895,A
2604,5208,-2604,1,0.464767082532185,A
2605,5210,-2605,1,0.5296600298938661,A
2608,5216,-2608,1,0.22359130649549996,A
2609,5218,-2609,1,0.6664271621929306,A
2610,5220,-2610,1,0.701151980567539,A
2611,5222,-2611,1,0.2241025016960959,A
2616,5232,-2616,1,0.9768131360112499,A
2620,5240,-2620,1,0.9256534214676679,A
2628,5256,-2628,1,0.1726955708929161,A
2629,5258,-2629,1,0.7591333705463759,A
2636,5272,-2636,1,0.024823074861003214,A
2637,5274,-2637,1,0.49510157028128077,A
2639,5278,-2639,1,0.12238381243161578,A
2641,5282,-2641,1,0.268688157747199,A
2642,5284,-2642,1,0.0911394272259548,A
2644,5288,-2644,1,0.6286098092430288,A
2645,5290,-2645,1,0.951128255727467,A
2646,5292,-2646,1,0.16478913493394387,A
2648,5296,-2648,1,0.9808058539297895,A
2653,5306,-2653,1,0.8983377849109736,A
2659,5318,-2659,1,0.9667961106382187,A
2664,5328,-2664,1,0.2582108119619596,A
2666,5332,-2666,1,0.40020867140815386,A
2667,5334,-2667,1,0.6305347482970833,A
2669,5338,-2669,1,0.12392144943300432,A
2670,5340,-2670,1,0.6720059355122814,A
2672,5344,-2672,1,0.6593678816516442,A
2673,5346,-2673,1,0.982479117666108,A
2676,5352,-2676,1,0.1903810268814018,A
2677,5354,-2677,1,0.4209367039287597,A
2688,5376,-2688,1,0.30236064640850613,A
2689,5378,-2689,1,0.21171230934259522,A
2695,5390,-2695,1,0.8383254730466789,A
2700,5400,-2700,1,0.48911236606891495,A
2702,5404,-2702,1,0.8491849310796749,A
2707,5414,-2707,1,0.09914868091219942,A
2717,5434,-2717,1,0.8157756085399196,A
2719,5438,-2719,1,0.7938883897805658,A
2722,5444,-2722,1,0.5195771420167322,A
2726,5452,-2726,1,0.898044657643741,A
2727,5454,-2727,1,0.7430789314620748,A
2729,5458,-2729,1,0.5596623129821394,A
2730,5460,-2730,1,0.756987799650988,A
2735,5470,-2735,1,0.1269155707122278,A
2736,5472,-2736,1,0.8120208424120544,A
2741,5482,-2741,1,0.5644076968235666,A
2745,5490,-2745,1,0.24962473572810073,A
2747,5494,-2747,1,0.10810991139291926,A
2748,5496,-2748,1,0.7079706647288351,A
2753,5506,-2753,1,0.7059434694375692,A
2754,5508,-2754,1,0.39318088480644997,A
2755,5510,-2755,1,0.12084606830137923,A
2757,5514,-2757,1,0.19017911839362456,A
2760,5520,-2760,1,0.9305353087383629,A
2761,5522,-2761,1,0.8030740063179455,A
2769,5538,-2769,1,0.9213353716622257,A
2772,5544,-2772,1,0.984168581434268,A
2774,5548,-2774,1,0.030741674036846578,A
2780,5560,-2780,1,0.04554449955888651,A
2781,5562,-2781,1,0.061667441664960854,A
2782,5564,-2782,1,0.048493392349753695,A
2784,5568,-2784,1,0.24563354694087625,A
2786,5572,-2786,1,0.6705020074437308,A
2787,5574,-2787,1,0.984045381776027,A
2789,5578,-2789,1,0.5201661915883118,A
2792,5584,-2792,1,0.7762802797006555,A
2794,5588,-2794,1,0.31539749354254254,A
2795,5590,-2795,1,0.6815747721812803,A
2796,5592,-2796,1,0.20244045656596033,A
2801,5602,-2801,1,0.7369177115171889,A
2802,5604,-2802,1,0.018751477107757375,A
2804,5608,-2804,1,0.586160657195177,A
2806,5612,-2806,1,0.23463309361066687,A
2813,5626,-2813,1,0.9184130074142784,A
2815,5630,-2815,1,0.9876642792777538,A
2816,5632,-2816,1,0.6746533746734018,A
2818,5636,-2818,1,0.06750393839087565,A
2824,5648,-2824,1,0.26640951882285024,A
2825,5650,-2825,1,0.9526754585954605,A
2826,5652,-2826,1,0.7416702140800161,A
2828,5656,-2828,1,0.7359527172918446,A
2831,5662,-2831,1,0.040412194365166854,A
2832,5664,-2832,1,0.5333935164608387,A
2838,5676,-2838,1,0.11001661339796376,A
2846,5692,-2846,1,0.868793218533507,A
2847,5694,-2847,1,0.9902412670572839,A
2852,5704,-2852,1,0.2444496390639147,A
2853,5706,-2853,1,0.9213680556289175,A
2857,5714,-2857,1,0.35050052548425303,A
2860,5720,-2860,1,0.7801306749116159,A
2861,5722,-2861,1,0.5528585770643312,A
2870,5740,-2870,1,0.2944542597535602,A
2874,5748,-2874,1,0.8200768082790767,A
2879,5758,-2879,1,0.598661314780307,A
2880,5760,-2880,1,0.13968279380638549,A
2881,5762,-2881,1,0.1531590361868308,A
2883,5766,-2883,1,0.45695359489422815,A
2885,5770,-2885,1,0.8085053133058951,A
2886,5772,-2886,1,0.3159276141750993,A
2888,5776,-2888,1,0.5518145756246141,A
2890,5780,-2890,1,0.5038434843103511,A
2891,5782,-2891,1,0.904271844817243,A
2895,5790,-2895,1,0.3229045631321894,A
2897,5794,-2897,1,0.04832736095660983,A
2904,5808,-2904,1,0.49864473425784206,A
2911,5822,-2911,1,0.36967045393288467,A
2912,5824,-2912,1,0.2681835604970485,A
2914,5828,-2914,1,0.5332913965193291,A
2916,5832,-2916,1,0.024104704960462908,A
2917,5834,-2917,1,0.37292518276527775,A
2919,5838,-2919,1,0.5952541899214293,A
2921,5842,-2921,1,0.9080087847125692,A
2925,5850,-2925,1,0.39070502923819295,A
2926,5852,-2926,1,0.784033900403487,A
2927,5854,-2927,1,0.2773163856559199,A
2929,5858,-2929,1,0.6764166036311287,A
2930,5860,-2930,1,0.46011033493678866,A
2933,5866,-2933,1,0.0986835889610922,A
2935,5870,-2935,1,0.2259015423640084,A
2936,5872,-2936,1,0.5770791882007408,A
2947,5894,-2947,1,0.46582383599914023,A
2953,5906,-2953,1,0.8327956840385945,A
2956,5912,-2956,1,0.498232996918768,A
2958,5916,-2958,1,0.3951271386717814,A
2961,5922,-2961,1,0.7347184897493771,A
2962,5924,-2962,1,0.7409127755094936,A
2970,5940,-2970,1,0.7240356931465204,A
2973,5946,-2973,1,0.4263239668142922,A
2975,5950,-2975,1,0.11288501682578134,A
2978,5956,-2978,1,0.64710882539368,A
2979,5958,-2979,1,0.13057569160095683,A
2980,5960,-2980,1,0.49152272101191063,A
2981,5962,-2981,1,0.5787611337900097,A
2990,5980,-2990,1,0.06632348866270044,A
2991,5982,-2991,1,0.13745538016277414,A
2996,5992,-2996,1,0.8070988673997107,A
2998,5996,-2998,1,0.84653495090758,A
3000,6000,-3000,1,0.1710422413940308,B
3004,6008,-3004,1,0.24239189142971573,B
3005,6010,-3005,1,0.8880739243696398,B
3006,6012,-3006,1,0.49907412390284667,B
3008,6016,-3008,1,0.044067084784232935,B
3011,6022,-3011,1,0.8514031489248932,B
3012,6024,-3012,1,0.13176701601583207,B
3013,6026,-3013,1,0.3122577692031193,B
3014,6028,-3014,1,0.7051259878389479,B
3019,6038,-3019,1,0.052125013175861046,B
3025,6050,-3025,1,0.7652672193676735,B
3028,6056,-3028,1,0.8184822987519869,B
3029,6058,-3029,1,0.6778671375998104,B
3030,6060,-3030,1,0.09372767171568863,B
3032,6064,-3032,1,0.857921998929685,B
3039,6078,-3039,1,0.7224446354950614,B
3040,6080,-3040,1,0.23824329554295365,B
3044,6088,-3044,1,0.08472550061650641,B
3049,6098,-3049,1,0.1368654702261587,B
3050,6100,-3050,1,0.22566155058529613,B
3052,6104,-3052,1,0.3906084405543425,B
3053,6106,-3053,1,0.19419809030589397,B
3055,6110,-3055,1,0.7730997805743312,B
3056,6112,-3056,1,0.07712846481294744,B
3058,6116,-3058,1,0.6309896460424579,B
3060,6120,-3060,1,0.21252389878242461,B
3063,6126,-3063,1,0.8560963321885723,B
3066,6132,-3066,1,0.8930300513510993,B
3067,6134,-3067,1,0.6735784731008889,B
3069,6138,-3069,1,0.8408048741184612,B
3070,6140,-3070,1,0.8423910681090043,B
3072,6144,-3072,1,0.7333758897465852,B
3079,6158,-3079,1,0.10304630945911197,B
3080,6160,-3080,1,0.6386629009594229,B
3081,6162,-3081,1,0.6527041789205796,B
3082,6164,-3082,1,0.3091399649653698,B
3085,6170,-3085,1,0.47927885436609863,B
3086,6172,-3086,1,0.5137765528965026,B
3092,6184,-3092,1,0.3234970984358385,B
3093,6186,-3093,1,0.9153224262989785,B
3098,6196,-3098,1,0.6062497171208013,B
3099,6198,-3099,1,0.9672320564461698,B
3107,6214,-3107,1,0.18364380338938235,B
3109,6218,-3109,1,0.40964356470554975,B
3112,6224,-3112,1,0.15074656212715565,B
3116,6232,-3116,1,0.4996896798417899,B
3118,6236,-3118,1,0.11361214311307033,B
3127,6254,-3127,1,0.8264462452732187,B
3135,6270,-3135,1,0.42954088965533466,B
3136,6272,-3136,1,0.8200259268639405,B
3137,6274,-3137,1,0.6331091015438854,B
3140,6280,-3140,1,0.19793073401671457,B
3142,6284,-3142,1,0.5796476773397663,B
3143,6286,-3143,1,0.6261148618705753,B
3144,6288,-3144,1,0.7701047805135995,B
3154,6308,-3154,1,0.518186934762647,B
3157,6314,-3157,1,0.5372491929857681,B
3165,6330,-3165,1,0.790345528224115,B
3168,6336,-3168,1,0.5304789049237794,B
3169,6338,-3169,1,0.43223184567840545,B
3170,6340,-3170,1,0.954814062170203,B
3171,6342,-3171,1,0.6477673566476618,B
3172,6344,-3172,1,0.4268804107319091,B
3173,6346,-3173,1,0.8264893767191442,B
3174,6348,-3174,1,0.4154461892301534,B
3176,6352,-3176,1,0.6348920433440249,B
3181,6362,-3181,1,0.5299750028015312,B
3184,6368,-3184,1,0.9339596024107337,B
3185,6370,-3185,1,0.13892642924617404,B
3187,6374,-3187,1,0.8421297267009326,B
3193,6386,-3193,1,0.5427229556350202,B
3196,6392,-3196,1,0.7884629457548686,B
3200,6400,-3200,1,0.8060378721237408,B
3202,6404,-3202,1,0.9856521498348815,B
3203,6406,-3203,1,0.9262295725014288,B
3208,6416,-3208,1,0.909699575847746,B
3212,6424,-3212,1,0.12058519406133761,B
3215,6430,-3215,1,0.7792573751964516,B
3220,6440,-3220,1,0.23718248592119284,B
3221,6442,-3221,1,0.6792156625770795,B
3222,6444,-3222,1,0.7546943884757409,B
3224,6448,-3224,1,0.049154500375607646,B
3229,6458,-3229,1,0.6434973644380836,B
3232,6464,-3232,1,0.7613972967333169,B
3236,6472,-3236,1,0.01669048758825742,B
3237,6474,-3237,1,0.7181379764347225,B
3238,6476,-3238,1,0.3054851278267854,B
3242,6484,-3242,1,0.5120729675818526,B
3251,6502,-3251,1,0.15864221817456803,B
3253,6506,-3253,1,0.43506302357282745,B
3255,6510,-3255,1,0.11583290510660482,B
3257,6514,-3257,1,0.22406130279168845,B
3259,6518,-3259,1,0.7751731602350622,B
3261,6522,-3261,1,0.3380154264071391,B
3272,6544,-3272,1,0.8976201115350151,B
3275,6550,-3275,1,0.5420267734143204,B
3276,6552,-3276,1,0.00719485565026412,B
3277,6554,-3277,1,0.22071231473346398,B
3278,6556,-3278,1,0.9002266464687592,B
3283,6566,-3283,1,0.620190142756737,B
3284,6568,-3284,1,0.7902157965580638,B
3285,6570,-3285,1,0.06756314664814311,B
3290,6580,-3290,1,0.9670190427042816,B
3295,6590,-3295,1,0.09164366014147762,B
3301,6602,-3301,1,0.5593902296736634,B
3302,6604,-3302,1,0.23110945573744146,B
3305,6610,-3305,1,0.5672089765339757,B
3310,6620,-3310,1,0.3611116670270398,B
3315,6630,-3315,1,0.07511220448066347,B
3316,6632,-3316,1,0.6421022895135409,B
3317,6634,-3317,1,0.3995573689292704,B
3321,6642,-3321,1,0.6338708932821541,B
3325,6650,-3325,1,0.4213677252567831,B
3326,6652,-3326,1,0.2178077177424227,B
3328,6656,-3328,1,0.07530436427257914,B
3329,6658,-3329,1,0.9469743091144097,B
3330,6660,-3330,1,0.7998595554592121,B
3331,6662,-3331,1,0.7854273330187054,B
3333,6666,-3333,1,0.4846967365580558,B
3334,6668,-3334,1,0.8197226241477152,B
3336,6672,-3336,1,0.5324932864439772,B
3337,6674,-3337,1,0.7117024871941552,B
3338,6676,-3338,1,0.4508083585882158,B
3339,6678,-3339,1,0.9761974058648885,B
3342,6684,-3342,1,0.8389091201489226,B
3345,6690,-3345,1,0.70916888161177,B
3346,6692,-3346,1,0.48032029334202664,B
3347,6694,-3347,1,0.08399850405343534,B
3350,6700,-3350,1,0.9519511204344645,B
3351,6702,-3351,1,0.35802405534576565,B
3354,6708,-3354,1,0.9834025970942166,B
3356,6712,-3356,1,0.9187634064036668,B
3359,6718,-3359,1,0.8059334007951073,B
3364,6728,-3364,1,0.6813730470495108,B
3365,6730,-3365,1,0.49951549184406074,B
3367,6734,-3367,1,0.8257785565396707,B
3374,6748,-3374,1,0.8728088757039755,B
3375,6750,-3375,1,0.7549378990448179,B
3376,6752,-3376,1,0.03852745653260914,B
3379,6758,-3379,1,0.39340905357662126,B
3380,6760,-3380,1,0.7426818539162025,B
3381,6762,-3381,1,0.9613709444960196,B
3385,6770,-3385,1,0.2450913456115319,B
3389,6778,-3389,1,0.5899418031965674,B
3390,6780,-3390,1,0.10981491384371278,B
3398,6796,-3398,1,0.03545831868062366,B
3402,6804,-3402,1,0.41848049954969035,B
3403,6806,-3403,1,0.6905249656000206,B
3404,6808,-3404,1,0.8860500401356188,B
3405,6810,-3405,1,0.16295629599546668,B
3406,6812,-3406,1,0.8892139968756227,B
3409,6818,-3409,1,0.16115891362976797,B
3415,6830,-3415,1,0.37911423288579305,B
3418,6836,-3418,1,0.7451738349108421,B
3425,6850,-3425,1,0.4670421071660126,B
3426,6852,-3426,1,0.598176659825583,B
3428,6856,-3428,1,0.6207313636776364,B
3433,6866,-3433,1,0.5402207672309675,B
3435,6870,-3435,1,0.3403777367188806,B
3436,6872,-3436,1,0.7640246401038283,B
3437,6874,-3437,1,0.8620592571803557,B
3438,6876,-3438,1,0.30862913785237933,B
3439,6878,-3439,1,0.5968634138872937,B
3442,6884,-3442,1,0.12425971844903816,B
3444,6888,-3444,1,0.931232113789874,B
3445,6890,-3445,1,0.4798821604393544,B
3450,6900,-3450,1,0.6351731780256941,B
3453,6906,-3453,1,0.004516823629387434,B
3454,6908,-3454,1,0.5078152898794224,B
3457,6914,-3457,1,0.1135863537595787,B
3461,6922,-3461,1,0.2967293889664112,B
3464,6928,-3464,1,0.2698026312420001,B
3466,6932,-3466,1,0.7329564179768814,B
3469,6938,-3469,1,0.420085931016852,B
3474,6948,-3474,1,0.5267508651827113,B
3476,6952,-3476,1,0.45029157047162005,B
3482,6964,-3482,1,0.6142153839107533,B
3485,6970,-3485,1,0.08513783398278219,B
3491,6982,-3491,1,0.44253913434255776,B
3493,6986,-3493,1,0.35212938884193823,B
3495,6990,-3495,1,0.9864903872863539,B
3502,7004,-3502,1,0.945158395763251,B
3504,7008,-3504,1,0.8321178447168455,B
3505,7010,-3505,1,0.23410418213119888,B
3509,7018,-3509,1,0.5592008543577334,B
3510,7020,-3510,1,0.0682502617671158,B
3511,7022,-3511,1,0.8722974550780856,B
3512,7024,-3512,1,0.022275711920009655,B
3513,7026,-3513,1,0.8872336353522459,B
3519,7038,-3519,1,0.6512443555131441,B
3521,7042,-3521,1,0.514828294517219,B
3522,7044,-3522,1,0.24524002721161198,B
3524,7048,-3524,1,0.5990118354259006,B
3526,7052,-3526,1,0.4706090424403675,B
3527,7054,-3527,1,0.6824589184708224,B
3529,7058,-3529,1,0.01913484616420069,B
3532,7064,-3532,1,0.2343071907087989,B
3534,7068,-3534,1,0.7271088631314434,B
3538,7076,-3538,1,0.09343569736135915,B
3539,7078,-3539,1,0.4693184019110135,B
3547,7094,-3547,1,0.01831894490303998,B
3554,7108,-3554,1,0.29177230448853597,B
3567,7134,-3567,1,0.07117717943695678,B
3574,7148,-3574,1,0.6373244546783001,B
3575,7150,-3575,1,0.7984918138682672,B
3587,7174,-3587,1,0.21951290278744573,B
3595,7190,-3595,1,0.0038334907738162283,B
3606,7212,-3606,1,0.9559972468796373,B
3608,7216,-3608,1,0.31896430619122285,B
3610,7220,-3610,1,0.8707399495461348,B
3614,7228,-3614,1,0.8928994012236361,B
3616,7232,-3616,1,0.5605997741431552,B
3618,7236,-3618,1,0.04769980117928374,B
3619,7238,-3619,1,0.5310353753060667,B
3623,7246,-3623,1,0.347492029937602,B
3629,7258,-3629,1,0.4315657153506417,B
3631,7262,-3631,1,0.2777206905008577,B
3633,7266,-3633,1,0.7866204523614365,B
3634,7268,-3634,1,0.37817191778056136,B
3637,7274,-3637,1,0.2405616363772427,B
3638,7276,-3638,1,0.11807101244461016,B
3640,7280,-3640,1,0.12520240567848429,B
3643,7286,-3643,1,0.780834219104135,B
3646,7292,-3646,1,0.2761717915642711,B
3649,7298,-3649,1,0.6410972783571804,B
3652,7304,-3652,1,0.7637533505897003,B
3656,7312,-3656,1,0.2511049015377145,B
3657,7314,-3657,1,0.8084940885145646,B
3658,7316,-3658,1,0.5945203272823585,B
3659,7318,-3659,1,0.03593822535293323,B
3660,7320,-3660,1,0.5506355930500181,B
3669,7338,-3669,1,0.7743666664982677,B
3674,7348,-3674,1,0.25369286366147037,B
3675,7350,-3675,1,0.8003972740875922,B
3684,7368,-3684,1,0.789156023480413,B
3686,7372,-3686,1,0.3540460629981529,B
3687,7374,-3687,1,0.6192639901122018,B
3689,7378,-3689,1,0.14744243350080566,B
3695,7390,-3695,1,0.9703635423565965,B
3699,7398,-3699,1,0.23419603161060853,B
3703,7406,-3703,1,0.5348813337374219,B
3704,7408,-3704,1,0.5420983980198777,B
3711,7422,-3711,1,0.4932423231934938,B
3712,7424,-3712,1,0.5607048451534079,B
3713,7426,-3713,1,0.047916544989727194,B
3717,7434,-3717,1,0.8667553916425935,B
3719,7438,-3719,1,0.3098229849994636,B
3720,7440,-3720,1,0.41270268757430273,B
3721,7442,-3721,1,0.5099905146558337,B
3722,7444,-3722,1,0.6692314353353409,B
3733,7466,-3733,1,0.6334138768416465,B
3740,7480,-3740,1,0.6746512953432319,B
3742,7484,-3742,1,0.3051153490901992,B
3745,7490,-3745,1,0.9203015570521338,B
3752,7504,-3752,1,0.25806250764281435,B
3768,7536,-3768,1,0.751125732903816,B
3769,7538,-3769,1,0.27569132704256527,B
3771,7542,-3771,1,0.8771644835331899,B
3782,7564,-3782,1,0.12145797381451606,B
3785,7570,-3785,1,0.94150346652668,B
3791,7582,-3791,1,0.45656488810252716,B
3794,7588,-3794,1,0.6354006987520949,B
3796,7592,-3796,1,0.7308640442455886,B
3803,7606,-3803,1,0.652079226388077,B
3819,7638,-3819,1,0.1504865280479114,B
3821,7642,-3821,1,0.0035735010762458774,B
3822,7644,-3822,1,0.2829979844911451,B
3823,7646,-3823,1,0.21398237434499212,B
3825,7650,-3825,1,0.962590745179464,B
3827,7654,-3827,1,0.5922999671011172,B
3829,7658,-3829,1,0.3364117906101133,B
3832,7664,-3832,1,0.0869935868109789,B
3835,7670,-3835,1,0.5114244445283614,B
3841,7682,-3841,1,0.0913940269851704,B
3847,7694,-3847,1,0.8800361191063594,B
3849,7698,-3849,1,0.9835163666020957,B
3853,7706,-3853,1,0.5898357687306492,B
3854,7708,-3854,1,0.6207469373117805,B
3859,7718,-3859,1,0.8695710047467087,B
3861,7722,-3861,1,0.31397804710833455,B
3862,7724,-3862,1,0.4014770966674669,B
3865,7730,-3865,1,0.48679326901531794,B
3869,7738,-3869,1,0.9501752475444447,B
3872,7744,-3872,1,0.9942192192755376,B
3873,7746,-3873,1,0.04735172098529428,B
3874,7748,-3874,1,0.8724900591585831,B
3875,7750,-3875,1,0.3991794169063897,B
3887,7774,-3887,1,0.85088709086591,B
3890,7780,-3890,1,0.4032148661182584,B
3894,7788,-3894,1,0.025595506316156147,B
3898,7796,-3898,1,0.48732144853921755,B
3910,7820,-3910,1,0.8947812754733581,B
3914,7828,-3914,1,0.9696545909777514,B
3917,7834,-3917,1,0.8876056246671182,B
3922,7844,-3922,1,0.28133091725710657,B
3924,7848,-3924,1,0.6528087487377129,B
3927,7854,-3927,1,0.4192052280950933,B
3928,7856,-3928,1,0.9944803054361931,B
3929,7858,-3929,1,0.7924098269324722,B
3934,7868,-3934,1,0.1038691668792816,B
3935,7870,-3935,1,0.7029868664033784,B
3939,7878,-3939,1,0.9871776420275079,B
3943,7886,-3943,1,0.540481410543898,B
3945,7890,-3945,1,0.0885112518845228,B
3947,7894,-3947,1,0.32553416073514874,B
3948,7896,-3948,1,0.31530689437266024,B
3949,7898,-3949,1,0.9282843535182189,B
3953,7906,-3953,1,0.5266930472088083,B
3957,7914,-3957,1,0.004651980764557417,B
3960,7920,-3960,1,0.8096525982118076,B
3964,7928,-3964,1,0.31801663017304305,B
3966,7932,-3966,1,0.6739958893840498,B
3969,7938,-3969,1,0.1758701389513282,B
3970,7940,-3970,1,0.5795747459351934,B
3971,7942,-3971,1,0.29705091826316576,B
3973,7946,-3973,1,0.8895973157837588,B
3974,7948,-3974,1,0.8692495699736369,B
3975,7950,-3975,1,0.1504074892517876,B
3987,7974,-3987,1,0.4072159672557172,B
3992,7984,-3992,1,0.8266521650609794,B
3994,7988,-3994,1,0.7417708248564239,B
3995,7990,-3995,1,0.5581053845189802,B
3998,7996,-3998,1,0.4473967591469601,B
4000,8000,-4000,1,0.037176594191005385,B
4001,8002,-4001,1,0.08411073149083581,B
4006,8012,-4006,1,0.35371660656320936,B
4008,8016,-4008,1,0.6316067432195985,B
4009,8018,-4009,1,0.5729239973412147,B
4012,8024,-4012,1,0.5971388408618765,B
4014,8028,-4014,1,0.622797607773582,B
4015,8030,-4015,1,0.8419715681063893,B
4018,8036,-4018,1,0.8865343826831223,B
4019,8038,-4019,1,0.09912782493275596,B
4020,8040,-4020,1,0.7754986955198684,B
4021,8042,-4021,1,0.43761948295626696,B
4027,8054,-4027,1,0.7510249197727922,B
4028,8056,-4028,1,0.795914399249015,B
4029,8058,-4029,1,0.5731034472670804,B
4030,8060,-4030,1,0.6915489356427701,B
4032,8064,-4032,1,0.4534077181793946,B
4035,8070,-4035,1,0.1485553435293333,B
4037,8074,-4037,1,0.8913023883074299,B
4040,8080,-4040,1,0.28835640377984983,B
4041,8082,-4041,1,0.1485525268059268,B
4046,8092,-4046,1,0.32366821245177524,B
4047,8094,-4047,1,0.9469565434214048,B
4048,8096,-4048,1,0.8432140072875236,B
4049,8098,-4049,1,0.9979166490098055,B
4050,8100,-4050,1,0.4316894877277123,B
4051,8102,-4051,1,0.3598366766374156,B
4052,8104,-4052,1,0.3841748852784894,B
4060,8120,-4060,1,0.5855841028513226,B
4061,8122,-4061,1,0.28110115377077405,B
4065,8130,-4065,1,0.9039885079768705,B
4068,8136,-4068,1,0.6527753848621564,B
4070,8140,-4070,1,0.3487182920360785,B
4072,8144,-4072,1,0.935169601915112,B
4073,8146,-4073,1,0.4947362117688291,B
4074,8148,-4074,1,0.4300128491256052,B
4075,8150,-4075,1,0.4128301029176884,B
4077,8154,-4077,1,0.03286001506355862,B
4084,8168,-4084,1,0.9988854320403507,B
4086,8172,-4086,1,0.0842897943284715,B
4088,8176,-4088,1,0.19871303268205465,B
4089,8178,-4089,1,0.6701449434834619,B
4090,8180,-4090,1,0.8246852601325168,B
4091,8182,-4091,1,0.8532768876114916,B
4096,8192,-4096,1,0.9336602646620561,B
4097,8194,-4097,1,0.9216844326844618,B
4099,8198,-4099,1,0.94109708844509,B
4101,8202,-4101,1,0.23109996296117596,B
4102,8204,-4102,1,0.5770602223153921,B
4106,8212,-4106,1,0.8210509354031769,B
4108,8216,-4108,1,0.18560204643175093,B
4110,8220,-4110,1,0.4422074431299263,B
4113,8226,-4113,1,0.5916158510787941,B
4117,8234,-4117,1,0.6158064176901017,B
4118,8236,-4118,1,0.5401754924021352,B
4120,8240,-4120,1,0.3404198183426961,B
4122,8244,-4122,1,0.9952454106287367,B
4123,8246,-4123,1,0.15708422135767786,B
4130,8260,-4130,1,0.30876281402782546,B
4131,8262,-4131,1,0.4342421195754306,B
4138,8276,-4138,1,0.9633087518111617,B
4139,8278,-4139,1,0.5547968462851842,B
4142,8284,-4142,1,0.01542216846020772,B
4144,8288,-4144,1,0.9997479890673151,B
4145,8290,-4145,1,0.07693641535921814,B
4158,8316,-4158,1,0.009608120545458898,B
4159,8318,-4159,1,0.39241106450012075,B
4161,8322,-4161,1,0.9252434133741699,B
4163,8326,-4163,1,0.22677441884716543,B
4165,8330,-4165,1,0.23111063060094694,B
4166,8332,-4166,1,0.5890830580158667,B
4169,8338,-4169,1,0.9224144765627956,B
4172,8344,-4172,1,0.39874733055374145,B
4173,8346,-4173,1,0.17444124473782108,B
4178,8356,-4178,1,0.6565390576711084,B
4180,8360,-4180,1,0.7755789500882249,B
4181,8362,-4181,1,0.3539709435300127,B
4183,8366,-4183,1,0.8821494970562171,B
4187,8374,-4187,1,0.7336342140260955,B
4194,8388,-4194,1,0.2516844725436883,B
4195,8390,-4195,1,0.9352687077599345,B
4197,8394,-4197,1,0.9994688894078213,B
4198,8396,-4198,1,0.5800108086562267,B
4202,8404,-4202,1,0.23483564587029626,B
4205,8410,-4205,1,0.9842859743032432,B
4211,8422,-4211,1,0.7962761015456371,B
4215,8430,-4215,1,0.7921097542876165,B
4226,8452,-4226,1,0.9328255173578425,B
4230,8460,-4230,1,0.8066338260221286,B
4232,8464,-4232,1,0.8766055275912688,B
4233,8466,-4233,1,0.2345167217719366,B
4240,8480,-4240,1,0.072259941810212,B
4241,8482,-4241,1,0.30296042086075725,B
4243,8486,-4243,1,0.637779898347496,B
4247,8494,-4247,1,0.7361923774192141,B
4249,8498,-4249,1,0.8072140288658411,B
4252,8504,-4252,1,0.6975340541526255,B
4254,8508,-4254,1,0.12943930010339433,B
4256,8512,-4256,1,0.1908758113598793,B
4257,8514,-4257,1,0.11626600042338009,B
4263,8526,-4263,1,0.2228913797592763,B
4264,8528,-4264,1,0.11583962524595004,B
4269,8538,-4269,1,0.8133977160027354,B
4271,8542,-4271,1,0.5827727537863147,B
4274,8548,-4274,1,0.5213434462306934,B
4278,8556,-4278,1,0.304073612107161,B
4279,8558,-4279,1,0.4568104564159625,B
4281,8562,-4281,1,0.797901895310087,B
4283,8566,-4283,1,0.452472135955274,B
4295,8590,-4295,1,0.599349474615618,B
4296,8592,-4296,1,0.35847481963460437,B
4300,8600,-4300,1,0.6667184609503497,B
4302,8604,-4302,1,0.407939864756551,B
4303,8606,-4303,1,0.3533042144526525,B
4307,8614,-4307,1,0.07017479301620744,B
4309,8618,-4309,1,0.9458405714346192,B
4316,8632,-4316,1,0.5441527398200848,B
4319,8638,-4319,1,0.38364593769543,B
4321,8642,-4321,1,0.36691385755289474,B
4322,8644,-4322,1,0.6053205298959325,B
4323,8646,-4323,1,0.9439800740289092,B
4329,8658,-4329,1,0.6370016727128033,B
4330,8660,-4330,1,0.0990320386620216,B
4334,8668,-4334,1,0.03952544913021727,B
4336,8672,-4336,1,0.5711349443235074,B
4339,8678,-4339,1,0.17391677902679048,B
4340,8680,-4340,1,0.6147707627888993,B
4341,8682,-4341,1,0.6825519145534751,B
4346,8692,-4346,1,0.29664474127805374,B
4349,8698,-4349,1,0.29586063131805007,B
4350,8700,-4350,1,0.46424174349609004,B
4352,8704,-4352,1,0.9575048167584049,B
4354,8708,-4354,1,0.10318411657494608,B
4355,8710,-4355,1,0.4696953326245895,B
4360,8720,-4360,1,0.36933803818733624,B
4361,8722,-4361,1,0.6932505938834007,B
4372,8744,-4372,1,0.9358667720101387,B
4373,8746,-4373,1,0.3546085915006407,B
4374,8748,-4374,1,0.6282892214650725,B
4375,8750,-4375,1,0.22172706845473755,B
4376,8752,-4376,1,0.7347903676345446,B
4380,8760,-4380,1,0.6166518304899364,B
4386,8772,-4386,1,0.33362001897653326,B
4387,8774,-4387,1,0.16629965386442414,B
4391,8782,-4391,1,0.3396138628657065,B
4393,8786,-4393,1,0.9051306591238312,B
4395,8790,-4395,1,0.9626544871589569,B
4396,8792,-4396,1,0.4789566253614709,B
4397,8794,-4397,1,0.5545386208619352,B
4399,8798,-4399,1,0.4862112158069364,B
4403,8806,-4403,1,0.39941591882437366,B
4405,8810,-4405,1,0.07431009142767031,B
4407,8814,-4407,1,0.49549593222970345,B
4411,8822,-4411,1,0.08635036399371487,B
4412,8824,-4412,1,0.033990254256572316,B
4417,8834,-4417,1,0.023607909366629154,B
4418,8836,-4418,1,0.4118443694362963,B
4421,8842,-4421,1,0.4270035593322885,B
4424,8848,-4424,1,0.2269210291169942,B
4425,8850,-4425,1,0.26666544140152404,B
4429,8858,-4429,1,0.937748732198313,B
4430,8860,-4430,1,0.813551888210128,B
4443,8886,-4443,1,0.8149677463465078,B
4447,8894,-4447,1,0.5818899684442137,B
4449,8898,-4449,1,0.304174183463205,B
4450,8900,-4450,1,0.40891002362657347,B
4454,8908,-4454,1,0.3352524608141173,B
4460,8920,-4460,1,0.4807575861185468,B
4462,8924,-4462,1,0.7516133600393959,B
4463,8926,-4463,1,0.3407093963682378,B
4464,8928,-4464,1,0.8500809125345706,B
4467,8934,-4467,1,0.5053624364417746,B
4468,8936,-4468,1,0.050927608866573326,B
4472,8944,-4472,1,0.19166123899094434,B
4474,8948,-4474,1,0.2923967486773832,B
4478,8956,-4478,1,0.8083153189002233,B
4481,8962,-4481,1,0.38895263980836037,B
4486,8972,-4486,1,0.10327995674886137,B
4487,8974,-4487,1,0.014701616581322408,B
4493,8986,-4493,1,0.6424955409423022,B
4506,9012,-4506,1,0.08259360677237937,B
4508,9016,-4508,1,0.14501984197646556,B
4509,9018,-4509,1,0.9639183684770001,B
4513,9026,-4513,1,0.2539576221184585,B
4515,9030,-4515,1,0.7414853428696094,B
4518,9036,-4518,1,0.365478865375362,B
4526,9052,-4526,1,0.24277360710056273,B
4527,9054,-4527,1,0.19870219451564752,B
4528,9056,-4528,1,0.5414899148906703,B
4532,9064,-4532,1,0.6066954177265278,B
4535,9070,-4535,1,0.8690411166046618,B
4540,9080,-4540,1,0.09633441109974661,B
4545,9090,-4545,1,0.7281253729119977,B
4547,9094,-4547,1,0.9919513006883015,B
4548,9096,-4548,1,0.7972722065573153,B
4551,9102,-4551,1,0.40059772058534127,B
4553,9106,-4553,1,0.8519394112715449,B
4555,9110,-4555,1,0.19498894786916776,B
4556,9112,-4556,1,0.3562516212939254,B
4558,9116,-4558,1,0.10688235449588512,B
4560,9120,-4560,1,0.971511656845119,B
4561,9122,-4561,1,0.9073836632200551,B
4564,9128,-4564,1,0.5289150143451903,B
4565,9130,-4565,1,0.39261144380882473,B
4567,9134,-4567,1,0.6291905343693677,B
4570,9140,-4570,1,0.7834995422408265,B
4572,9144,-4572,1,0.02770481329553831,B
4574,9148,-4574,1,0.8710123733718439,B
4575,9150,-4575,1,0.645609467464967,B
4582,9164,-4582,1,0.057307139086681724,B
4584,9168,-4584,1,0.5775971998792729,B
4589,9178,-4589,1,0.4968326542630851,B
4590,9180,-4590,1,0.7137082505096735,B
4594,9188,-4594,1,0.11715520729151407,B
4599,9198,-4599,1,0.2804297639678368,B
4601,9202,-4601,1,0.7713727480268862,B
4605,9210,-4605,1,0.6762830948159525,B
4610,9220,-4610,1,0.46560584574366215,B
4612,9224,-4612,1,0.06577807435685823,B
4614,9228,-4614,1,0.05475676960603404,B
4620,9240,-4620,1,0.1203501462671317,B
4621,9242,-4621,1,0.066777839047647,B
4623,9246,-4623,1,0.9149260035430216,B
4624,9248,-4624,1,0.20430766385261856,B
4626,9252,-4626,1,0.127813480471333,B
4630,9260,-4630,1,0.7827148522649873,B
4632,9264,-4632,1,0.20071728208036865,B
4634,9268,-4634,1,0.89952976763576,B
4637,9274,-4637,1,0.8645970990225208,B
4638,9276,-4638,1,0.8852230020162161,B
4639,9278,-4639,1,0.7759844158497151,B
4640,9280,-4640,1,0.1546281881812286,B
4653,9306,-4653,1,0.5749619047768698,B
4654,9308,-4654,1,0.23787367076516086,B
4656,9312,-4656,1,0.35147311433207973,B
4661,9322,-4661,1,0.7216650364611302,B
4662,9324,-4662,1,0.8804230042329816,B
4664,9328,-4664,1,0.12191576579312735,B
4665,9330,-4665,1,0.5404097523959632,B
4667,9334,-4667,1,0.8078737333513207,B
4677,9354,-4677,1,0.030096416560586703,B
4681,9362,-4681,1,0.8243640345172009,B
4684,9368,-4684,1,0.7963076659484881,B
4685,9370,-4685,1,0.40684372589474194,B
4686,9372,-4686,1,0.41048930215066415,B
4702,9404,-4702,1,0.9396680932575422,B
4705,9410,-4705,1,0.5510052542145123,B
4708,9416,-4708,1,0.2320940399337169,B
4709,9418,-4709,1,0.5363669902961519,B
4711,9422,-4711,1,0.179017841512235,B
4712,9424,-4712,1,0.6999605652783912,B
4713,9426,-4713,1,0.1495192198094596,B
4715,9430,-4715,1,0.9097716104307351,B
4719,9438,-4719,1,0.1193070205609793,B
4720,9440,-4720,1,0.08319181171725043,B
4722,9444,-4722,1,0.09107356410096512,B
4724,9448,-4724,1,0.5447715745848909,B
4726,9452,-4726,1,0.4928981412038589,B
4727,9454,-4727,1,0.4994432355660158,B
4732,9464,-4732,1,0.5300045392135037,B
4733,9466,-4733,1,0.8625350322533041,B
4746,9492,-4746,1,0.5262736903778428,B
4747,9494,-4747,1,0.7705199265607263,B
4748,9496,-4748,1,0.9188425706163276,B
4749,9498,-4749,1,0.6774573799542221,B
4751,9502,-4751,1,0.9526072112978978,B
4753,9506,-4753,1,0.43373776416355514,B
4756,9512,-4756,1,0.43831642382024205,B
4764,9528,-4764,1,0.6045477441468303,B
4768,9536,-4768,1,0.7937248573109028,B
4769,9538,-4769,1,0.6659413457111958,B
4770,9540,-4770,1,0.6413045411098759,B
4775,9550,-4775,1,0.1810683418607898,B
4780,9560,-4780,1,0.6222214714523887,B
4784,9568,-4784,1,0.3866361959938588,B
4789,9578,-4789,1,0.5260086531121715,B
4790,9580,-4790,1,0.7311171467422967,B
4791,9582,-4791,1,0.742809228532098,B
4792,9584,-4792,1,0.24040154559686244,B
4795,9590,-4795,1,0.7935533898498188,B
4800,9600,-4800,1,0.9519662082568066,B
4803,9606,-4803,1,0.5990175640338654,B
4805,9610,-4805,1,0.1485674084974169,B
4806,9612,-4806,1,0.9364389694035902,B
4810,9620,-4810,1,0.3900302591262105,B
4817,9634,-4817,1,0.7188610694406621,B
4818,9636,-4818,1,0.2157184444512552,B
4824,9648,-4824,1,0.2115623006390298,B
4829,9658,-4829,1,0.23551743293397154,B
4830,9660,-4830,1,0.21732272192384605,B
4832,9664,-4832,1,0.03204477598343025,B
4833,9666,-4833,1,0.7119094881360511,B
4836,9672,-4836,1,0.3281724907518774,B
4838,9676,-4838,1,0.8864593843732111,B
4839,9678,-4839,1,0.4857506606427121,B
4845,9690,-4845,1,0.5361075867515942,B
4847,9694,-4847,1,0.02925370083687051,B
4848,9696,-4848,1,0.07132480066636793,B
4849,9698,-4849,1,0.12980016029948394,B
4850,9700,-4850,1,0.13310595196513408,B
4851,9702,-4851,1,0.47807297106504054,B
4854,9708,-4854,1,0.8784870968976762,B
4858,9716,-4858,1,0.037243181066369035,B
4860,9720,-4860,1,0.9305569185962953,B
4861,9722,-4861,1,0.609248496587377,B
4862,9724,-4862,1,0.1231226242148844,B
4864,9728,-4864,1,0.3714474512887683,B
4871,9742,-4871,1,0.940674916592476,B
4875,9750,-4875,1,0.4865342871114904,B
4880,9760,-4880,1,0.4342304639768426,B
4881,9762,-4881,1,0.9126182281460703,B
4885,9770,-4885,1,0.24043968875064592,B
4888,9776,-4888,1,0.3574749145761895,B
4890,9780,-4890,1,0.19545486365407183,B
4891,9782,-4891,1,0.27904457067194455,B
4898,9796,-4898,1,0.8224400482678652,B
4899,9798,-4899,1,0.445298399147413,B
4900,9800,-4900,1,0.8387774765459896,B
4904,9808,-4904,1,0.5732388992852749,B
4905,9810,-4905,1,0.5150130068021369,B
4909,9818,-4909,1,0.5178391244577188,B
4911,9822,-4911,1,0.842812651696026,B
4916,9832,-4916,1,0.6431830226580991,B
4918,9836,-4918,1,0.6821482133616881,B
4921,9842,-4921,1,0.7214056581161982,B
4922,9844,-4922,1,0.866101446619141,B
4923,9846,-4923,1,0.8844765606685705,B
4929,9858,-4929,1,0.23562368581202697,B
4930,9860,-4930,1,0.8838911793561127,B
4931,9862,-4931,1,0.465814178670066,B
4936,9872,-4936,1,0.6273734222363628,B
4939,9878,-4939,1,0.8803352447193122,B
4944,9888,-4944,1,0.9281434754557922,B
4948,9896,-4948,1,0.5683432033632443,B
4949,9898,-4949,1,0.3254907292996869,B
4951,9902,-4951,1,0.6601406645964281,B
4955,9910,-4955,1,0.7448624166883406,B
4956,9912,-4956,1,0.6588403284917861,B
4959,9918,-4959,1,0.48869982860347405,B
4961,9922,-4961,1,0.5083427908466228,B
4963,9926,-4963,1,0.2499140116949834,B
4964,9928,-4964,1,0.9301375629424492,B
4968,9936,-4968,1,0.44555992579878034,B
4973,9946,-4973,1,0.946898489927852,B
4976,9952,-4976,1,0.2781835519242303,B
4978,9956,-4978,1,0.24751673032129817,B
4981,9962,-4981,1,0.8597871620546799,B
4990,9980,-4990,1,0.3534826784871,B
4999,9998,-4999,1,0.8216531578091468,B
5002,10004,-5002,1,0.14961705322384566,B
5004,10008,-5004,1,0.6393091460602661,B
5008,10016,-5008,1,0.815658997435121,B
5009,10018,-5009,1,0.1323068349522608,B
5010,10020,-5010,1,0.47019470171537225,B
5011,10022,-5011,1,0.36391734868224435,B
5013,10026,-5013,1,0.5622171550425171,B
5014,10028,-5014,1,0.5963834703503528,B
5021,10042,-5021,1,0.3566911696654381,B
5025,10050,-5025,1,0.969759352046603,B
5031,10062,-5031,1,0.9796903393765671,B
5032,10064,-5032,1,0.8707042508169783,B
5035,10070,-5035,1,0.7732307846078125,B
5041,10082,-5041,1,0.16445161376744533,B
5043,10086,-5043,1,0.733313589241992,B
5044,10088,-5044,1,0.29587451888795,B
5047,10094,-5047,1,0.34481137939403017,B
5051,10102,-5051,1,0.7381506257264231,B
5052,10104,-5052,1,0.49745613428705804,B
5054,10108,-5054,1,0.16821512521599102,B
5056,10112,-5056,1,0.6956314866723081,B
5059,10118,-5059,1,0.5710048682637316,B
5063,10126,-5063,1,0.40868373874747566,B
5066,10132,-5066,1,0.4577258177094551,B
5067,10134,-5067,1,0.9471473507021898,B
5068,10136,-5068,1,0.9373857902593928,B
5070,10140,-5070,1,0.4746372735554849,B
5071,10142,-5071,1,0.7715352333226455,B
5073,10146,-5073,1,0.6448016032212864,B
5076,10152,-5076,1,0.8804721854476941,B
5079,10158,-5079,1,0.35965137960371585,B
5080,10160,-5080,1,0.7451845787410342,B
5084,10168,-5084,1,0.4449786902519165,B
5087,10174,-5087,1,0.43634684939758495,B
5088,10176,-5088,1,0.09803399847117245,B
5096,10192,-5096,1,0.3764610412376198,B
5097,10194,-5097,1,0.27040132268937034,B
5102,10204,-5102,1,0.07301881020796552,B
5110,10220,-5110,1,0.9582381044488772,B
5111,10222,-5111,1,0.9395523414717533,B
5122,10244,-5122,1,0.3093641689117038,B
5124,10248,-5124,1,0.7972258900250551,B
5125,10250,-5125,1,0.2027719424436486,B
5127,10254,-5127,1,0.23466754040274884,B
5129,10258,-5129,1,0.11948575088843172,B
5140,10280,-5140,1,0.4594407066823344,B
5141,10282,-5141,1,0.11096311754865706,B
5145,10290,-5145,1,0.4356889183808744,B
5147,10294,-5147,1,0.23045859207651154,B
5152,10304,-5152,1,0.8236292253396106,B
5153,10306,-5153,1,0.4424114558264022,B
5162,10324,-5162,1,0.9622226165311129,B
5163,10326,-5163,1,0.9879282922172551,B
5165,10330,-5165,1,0.3508120693774611,B
5167,10334,-5167,1,0.9205853030503303,B
5169,10338,-5169,1,0.145283257145993,B
5170,10340,-5170,1,0.05232148233608713,B
5172,10344,-5172,1,0.13318558109051837,B
5173,10346,-5173,1,0.9807762769060511,B
5174,10348,-5174,1,0.5871597219131403,B
5175,10350,-5175,1,0.8686244321429857,B
5176,10352,-5176,1,0.2751843529909025,B
5184,10368,-5184,1,0.38325653056466047,B
5187,10374,-5187,1,0.8767896543363191,B
5188,10376,-5188,1,0.20308115944817395,B
5194,10388,-5194,1,0.4707050630739148,B
5195,10390,-5195,1,0.25088230975833203,B
5200,10400,-5200,1,0.03041075151844652,B
5201,10402,-5201,1,0.4363481758976374,B
5209,10418,-5209,1,0.6361572352686237,B
5210,10420,-5210,1,0.6107870822250155,B
5211,10422,-5211,1,0.5291930891412713,B
5212,10424,-5212,1,0.5700236388673608,B
5215,10430,-5215,1,0.8640236777662672,B
5216,10432,-5216,1,0.9479281788301435,B
5219,10438,-5219,1,0.83861323464415,B
5221,10442,-5221,1,0.6047758964193912,B
5224,10448,-5224,1,0.6951882271425909,B
5227,10454,-5227,1,0.6945812079763211,B
5229,10458,-5229,1,0.5977943362145981,B
5230,10460,-5230,1,0.23583704264758454,B
5234,10468,-5234,1,0.7629508306279926,B
5235,10470,-5235,1,0.46254513763824767,B
5236,10472,-5236,1,0.9288906243768238,B
5240,10480,-5240,1,0.2197314363736319,B
5241,10482,-5241,1,0.6951658590816929,B
5242,10484,-5242,1,0.7942519151269615,B
5246,10492,-5246,1,0.19369333920231224,B
5249,10498,-5249,1,0.34578540306535877,B
5253,10506,-5253,1,0.8111883378082042,B
5259,10518,-5259,1,0.6216590885651353,B
5276,10552,-5276,1,0.14050516213716924,B
5280,10560,-5280,1,0.2364078648601725,B
5281,10562,-5281,1,0.5288122596807787,B
5282,10564,-5282,1,0.02572239063715065,B
5283,10566,-5283,1,0.29016088073941737,B
5288,10576,-5288,1,0.472068994862087,B
5293,10586,-5293,1,0.6621209752667574,B
5297,10594,-5297,1,0.651819638069821,B
5302,10604,-5302,1,0.38076041035870545,B
5303,10606,-5303,1,0.3410632710185082,B
5313,10626,-5313,1,0.6472117814391007,B
5318,10636,-5318,1,0.6567784114093752,B
5319,10638,-5319,1,0.8922462975530374,B
5320,10640,-5320,1,0.9406758207654013,B
5326,10652,-5326,1,0.1393802951301235,B
5328,10656,-5328,1,0.9288512248969271,B
5329,10658,-5329,1,0.8046251769653237,B
5335,10670,-5335,1,0.7997910101021933,B
5336,10672,-5336,1,0.8815783227285694,B
5340,10680,-5340,1,0.6589850285501045,B
5343,10686,-5343,1,0.6874659636323736,B
5346,10692,-5346,1,0.875215821916142,B
5348,10696,-5348,1,0.2993790523413121,B
5350,10700,-5350,1,0.20979563052754435,B
5354,10708,-5354,1,0.968177073236767,B
5357,10714,-5357,1,0.7118167641895226,B
5362,10724,-5362,1,0.9252668202721668,B
5364,10728,-5364,1,0.3571422492394486,B
5368,10736,-5368,1,0.9359194817430727,B
5372,10744,-5372,1,0.7509971298891508,B
5376,10752,-5376,1,0.8859605921243652,B
5377,10754,-5377,1,0.7201129739783861,B
5378,10756,-5378,1,0.7765867051615293,B
5386,10772,-5386,1,0.5451040602139269,B
5387,10774,-5387,1,0.22964421252053602,B
5392,10784,-5392,1,0.825855029233761,B
5396,10792,-5396,1,0.49165884935949444,B
5397,10794,-5397,1,0.843339559931538,B
5402,10804,-5402,1,0.7515999630932464,B
5403,10806,-5403,1,0.3706260309897429,B
5406,10812,-5406,1,0.8200266427118071,B
5410,10820,-5410,1,0.6241643216584177,B
5412,10824,-5412,1,0.5857060266234105,B
5413,10826,-5413,1,0.16359811963117088,B
5414,10828,-5414,1,0.9376296053087558,B
5416,10832,-5416,1,0.16178694519810743,B
5421,10842,-5421,1,0.339035729708942,B
5422,10844,-5422,1,0.6556076952213551,B
5425,10850,-5425,1,0.4632522546404455,B
5427,10854,-5427,1,0.5935628202972276,B
5428,10856,-5428,1,0.4612998074451816,B
5433,10866,-5433,1,0.8576384511810695,B
5437,10874,-5437,1,0.7567448241924546,B
5439,10878,-5439,1,0.9636636577487555,B
5442,10884,-5442,1,0.8317381361193429,B
5446,10892,-5446,1,0.4027511796406188,B
5448,10896,-5448,1,0.24945334753675918,B
5449,10898,-5449,1,0.046705000672739416,B
5450,10900,-5450,1,0.9293350005490852,B
5454,10908,-5454,1,0.17683269768757226,B
5460,10920,-5460,1,0.675649767676929,B
5461,10922,-5461,1,0.47359960701071246,B
5468,10936,-5468,1,0.6135129072036142,B
5470,10940,-5470,1,0.6051433982731282,B
5475,10950,-5475,1,0.6368306115314385,B
5481,10962,-5481,1,0.5578268070799586,B
5483,10966,-5483,1,0.6680038459554201,B
5485,10970,-5485,1,0.2851434352649459,B
5492,10984,-5492,1,0.18912850230342237,B
5494,10988,-5494,1,0.5431622077749737,B
5495,10990,-5495,1,0.06247115735710973,B
5511,11022,-5511,1,0.4102952125396233,B
5514,11028,-5514,1,0.2880973925555709,B
5515,11030,-5515,1,0.9294151591626508,B
5517,11034,-5517,1,0.026313425121341827,B
5521,11042,-5521,1,0.2957352311592668,B
5525,11050,-5525,1,0.9634385510980633,B
5526,11052,-5526,1,0.13859286671391235,B
5528,11056,-5528,1,0.2476863981319074,B
5531,11062,-5531,1,0.5606699709959977,B
5535,11070,-5535,1,0.12399547838158831,B
5538,11076,-5538,1,0.6784016813860874,B
5540,11080,-5540,1,0.3446982524551603,B
5541,11082,-5541,1,0.7298484470025729,B
5548,11096,-5548,1,0.9518368353168508,B
5551,11102,-5551,1,0.3692348426930341,B
5556,11112,-5556,1,0.31237674260294945,B
5558,11116,-5558,1,0.5061874895103703,B
5560,11120,-5560,1,0.43169618884013616,B
5562,11124,-5562,1,0.34977806302715964,B
5568,11136,-5568,1,0.08780982180817631,B
5569,11138,-5569,1,0.9551941707491961,B
5570,11140,-5570,1,0.6114035762042292,B
5576,11152,-5576,1,0.8402808258476371,B
5577,11154,-5577,1,0.596795391279785,B
5578,11156,-5578,1,0.20379706716640134,B
5581,11162,-5581,1,0.6025548177063907,B
5583,11166,-5583,1,0.06757679395634386,B
5589,11178,-5589,1,0.5648752735232797,B
5591,11182,-5591,1,0.9846656679637688,B
5593,11186,-5593,1,0.743494803049847,B
5595,11190,-5595,1,0.5142831572451946,B
5598,11196,-5598,1,0.7056606571504257,B
5605,11210,-5605,1,0.560886367062344,B
5608,11216,-5608,1,0.5491975292749575,B
5612,11224,-5612,1,0.7502364742371062,B
5619,11238,-5619,1,0.8386788420273193,B
5620,11240,-5620,1,0.024695013643140196,B
5623,11246,-5623,1,0.6411475937531763,B
5626,11252,-5626,1,0.48952681074458404,B
5630,11260,-5630,1,0.9545910471773839,B
5631,11262,-5631,1,0.45719847855059403,B
5645,11290,-5645,1,0.3002313972395657,B
5649,11298,-5649,1,0.5879441852888027,B
5650,11300,-5650,1,0.19956042504371163,B
5656,11312,-5656,1,0.6982979999811362,B
5657,11314,-5657,1,0.2989472540315409,B
5659,11318,-5659,1,0.4036575602776902,B
5665,11330,-5665,1,0.30217068385529366,B
5667,11334,-5667,1,0.6928069947462601,B
5677,11354,-5677,1,0.3486304911410719,B
5680,11360,-5680,1,0.09298083488208475,B
5681,11362,-5681,1,0.9010076715805594,B
5685,11370,-5685,1,0.0760971835358587,B
5686,11372,-5686,1,0.6406902215941246,B
5687,11374,-5687,1,0.8557029788475528,B
5690,11380,-5690,1,0.25608805207437746,B
5693,11386,-5693,1,0.19974150470985963,B
5696,11392,-5696,1,0.6787930417054698,B
5697,11394,-5697,1,4.6659347910704696e-05,B
5698,11396,-5698,1,0.8881755603504322,B
5702,11404,-5702,1,0.6799324037269702,B
5705,11410,-5705,1,0.6002827312129777,B
5706,11412,-5706,1,0.35606453133530946,B
5708,11416,-5708,1,0.30253510406593864,B
5714,11428,-5714,1,0.5332789106667303,B
5718,11436,-5718,1,0.1003197010407485,B
5720,11440,-5720,1,0.7938045228316319,B
5722,11444,-5722,1,0.055154601135876,B
5725,11450,-5725,1,0.6460308013795877,B
5729,11458,-5729,1,0.9397201620885367,B
5730,11460,-5730,1,0.6081180246241779,B
5734,11468,-5734,1,0.26407625153938674,B
5735,11470,-5735,1,0.9873703987447003,B
5736,11472,-5736,1,0.8623949847670992,B
5738,11476,-5738,1,0.7898034423047712,B
5741,11482,-5741,1,0.4614137909370005,B
5742,11484,-5742,1,0.4942022761319902,B
5745,11490,-5745,1,0.28651040431145836,B
5746,11492,-5746,1,0.5755654584935721,B
5749,11498,-5749,1,0.8024911233856102,B
5751,11502,-5751,1,0.36579586026076527,B
5752,11504,-5752,1,0.2912747292568978,B
5757,11514,-5757,1,0.5525809797177695,B
5770,11540,-5770,1,0.894888777910319,B
5773,11546,-5773,1,0.8676968008999575,B
5782,11564,-5782,1,0.5680531732778332,B
5789,11578,-5789,1,0.2521373946448723,B
5790,11580,-5790,1,0.8783625606579066,B
5794,11588,-5794,1,0.9079394290592525,B
5800,11600,-5800,1,0.8257605138690517,B
5801,11602,-5801,1,0.7254879599154137,B
5805,11610,-5805,1,0.2726337191782967,B
5809,11618,-5809,1,0.15466688797563677,B
5810,11620,-5810,1,0.07709422335673322,B
5811,11622,-5811,1,0.5088679839380367,B
5815,11630,-5815,1,0.6162245960141777,B
5817,11634,-5817,1,0.6195889892774181,B
5818,11636,-5818,1,0.09296585309435512,B
5819,11638,-5819,1,0.43261654174251585,B
5821,11642,-5821,1,0.003982237003652189,B
5822,11644,-5822,1,0.5912204800733208,B
5824,11648,-5824,1,0.5827401052940304,B
5825,11650,-5825,1,0.6846253045526588,B
5827,11654,-5827,1,0.4501226927460543,B
5828,11656,-5828,1,0.7860172473923811,B
5829,11658,-5829,1,0.3841630350671834,B
5831,11662,-5831,1,0.651359264962849,B
5835,11670,-5835,1,0.4483000617638505,B
5837,11674,-5837,1,0.44259829842313236,B
5838,11676,-5838,1,0.384456094491885,B
5839,11678,-5839,1,0.4903467895824626,B
5841,11682,-5841,1,0.49243463159864553,B
5842,11684,-5842,1,0.07658716399529586,B
5844,11688,-5844,1,0.7322278569219153,B
5845,11690,-5845,1,0.3138103930000079,B
5846,11692,-5846,1,0.6322235124031401,B
5851,11702,-5851,1,0.41973241267065053,B
5854,11708,-5854,1,0.8885957779395856,B
5859,11718,-5859,1,0.3937688189128651,B
5861,11722,-5861,1,0.24692879666095824,B
5865,11730,-5865,1,0.9230582818398166,B
5868,11736,-5868,1,0.1251397260432917,B
5869,11738,-5869,1,0.05138375994262823,B
5870,11740,-5870,1,0.4149077197462009,B
5872,11744,-5872,1,0.04673204090611771,B
5873,11746,-5873,1,0.17250289801341467,B
5875,11750,-5875,1,0.7217628719471658,B
5876,11752,-5876,1,0.542775894415874,B
5880,11760,-5880,1,0.9931051272662894,B
5882,11764,-5882,1,0.9743243720623029,B
5888,11776,-5888,1,0.774705088324227,B
5898,11796,-5898,1,0.32789797348264504,B
5901,11802,-5901,1,0.4106018089494474,B
5903,11806,-5903,1,0.5600791951373958,B
5910,11820,-5910,1,0.015236577325917877,B
5911,11822,-5911,1,0.8070060536965792,B
5912,11824,-5912,1,0.7797709063833121,B
5914,11828,-5914,1,0.9493122600108239,B
5921,11842,-5921,1,0.42566597466574885,B
5922,11844,-5922,1,0.17710324491112117,B
5923,11846,-5923,1,0.49467502017725196,B
5924,11848,-5924,1,0.33660007001628356,B
5925,11850,-5925,1,0.5254756116458582,B
5928,11856,-5928,1,0.6574261855195614,B
5929,11858,-5929,1,0.9703853606742274,B
5931,11862,-5931,1,0.7944748447478724,B
5933,11866,-5933,1,0.20920845219455675,B
5934,11868,-5934,1,0.9567896705330894,B
5941,11882,-5941,1,0.5308697431480832,B
5943,11886,-5943,1,0.2208989707667881,B
5950,11900,-5950,1,0.28000700472220486,B
5955,11910,-5955,1,0.5416543218499014,B
5957,11914,-5957,1,0.284542563092793,B
5962,11924,-5962,1,0.6513807087679621,B
5966,11932,-5966,1,0.03716793977782962,B
5968,11936,-5968,1,0.9661270007262507,B
5970,11940,-5970,1,0.010752401375327403,B
5974,11948,-5974,1,0.832043916346839,B
5975,11950,-5975,1,0.0921249962593792,B
5983,11966,-5983,1,0.7075141576159617,B
5988,11976,-5988,1,0.017185569340113838,B
5993,11986,-5993,1,0.1250256750172929,B
